#VaccinesSaveLungs	vaccines:[]	save:[]	lungs:[]	
#NoVaccinePassports	no:[]	vaccine:[]	passports:[]	
#NoVaccinePassportsA	a:[]	no:[]	vaccine:[]	passports:[]	
#NorthOfTheWall	the:[]	of:[]	north:[]	wall:[]	
#ResigbSturgeon	resigb:[]	sturgeon:[]	
#CovidMandates	covid:[]	mandates:[]	
#BringAllMPsToTheirKnees	all:[]	ps:[]	knees:[]	bring:[]	their:[]	to:[]	m:[]	
#ChildrensDay	childrens:[]	day:[]	
#SeparateSociety	society:[]	separate:[]	
#PandemicFraud	fraud:[]	pandemic:[]	
#CovidSociopth	sociopth:[]	covid:[]	
#ItWasAScam	a:[]	was:[]	scam:[]	it:[]	
#ScienceForHire	hire:[]	science:[]	for:[]	
#ChinaJoe	joe:[]	china:[]	
#SayNoToCovidTyranny	no:[]	covid:[]	tyranny:[]	say:[]	to:[]	
#SmallPox	small:[]	pox:[]	
#MaajidNawaz	nawaz:[]	maajid:[]	
#RiseUp	up:[]	rise:[]	
#TarAndFeathers	tar:[]	feathers:[]	and:[]	
#NurseTwitter	twitter:[]	nurse:[]	
#BigBird	big:[]	bird:[]	
#DanNext	next:[]	dan:[]	
#NYCs	cs:[]	y:[]	n:[]	
#StairmanDan	dan:[]	stairman:[]	
#HPVvaccine	p:[]	h:[]	vvaccine:[]	
#LetsGo	go:[]	lets:[]	
#DoNotComplyEVER	r:[]	not:[]	comply:[]	e:[]	v:[]	do:[]	
#HumanRights	rights:[]	human:[]	
#ResistTheNWO	the:[]	w:[]	resist:[]	n:[]	o:[]	
#NeverBelieveMaximeBernier	bernier:[]	never:[]	maxime:[]	believe:[]	
#AfricanAmerican	african:[]	american:[]	
#novaXmandates	xmandates:[]	nova:[]	
#AwakeYet	yet:[]	awake:[]	
#HumanityFirst	first:[]	humanity:[]	
#RiseUP	p:[]	u:[]	rise:[]	
#RulesForTheeNotForMe	not:[]	thee:[]	me:[]	for:[]	rules:[]	
#EnoughisEnougth	enougth:[]	enoughis:[]	
#BecomeUngovernable	ungovernable:[]	become:[]	
#CovidIDIOTS	covid:[]	s:[]	t:[]	d:[]	i:[]	o:[]	
#TyrantsHaveOnePlaceToSwing	swing:[]	one:[]	have:[]	tyrants:[]	to:[]	place:[]	
#NoVaccinePassportA	a:[]	no:[]	vaccine:[]	passport:[]	
#TWorldCupFinal	world:[]	t:[]	final:[]	cup:[]	
#RedPill	red:[]	pill:[]	
#CentralAmerica	central:[]	america:[]	
#SturgeonSyndrome	syndrome:[]	sturgeon:[]	
#SouthAfrica	africa:[]	south:[]	
#NoCoersion	no:[]	coersion:[]	
#BlueWave	blue:[]	wave:[]	
#ItIs	is:[]	it:[]	
#COVvaccinesdontwork	c:[]	vvaccinesdontwork:[]	o:[]	
#GemmaODoherty	gemma:[]	doherty:[]	o:[]	
#VotePPC	p:[]	c:[]	vote:[]	
#CovidConspiracies	covid:[]	conspiracies:[]	
#MedicalApathide	apathide:[]	medical:[]	
#GetVaccinatedBitches	bitches:[]	get:[]	vaccinated:[]	
#CrimesA	a:[]	crimes:[]	
#AlecBaldwin	alec:[]	baldwin:[]	
#thisisVaccineCoercion	vaccine:[]	thisis:[]	coercion:[]	
#NovaScotia	scotia:[]	nova:[]	
#PfizerVaccine	vaccine:[]	pfizer:[]	
#NeverForgetNeverForgive	never:[]	forget:[]	forgive:[]	
#ThrowAway	away:[]	throw:[]	
#ToldYouSo	told:[]	so:[]	you:[]	
#NoMask	no:[]	mask:[]	
#BBCBreakfast	b:[]	c:[]	breakfast:[]	
#BlackPantherWakandaForever	wakanda:[]	black:[]	panther:[]	forever:[]	
#ArrestMengeleMatt	mengele:[]	arrest:[]	matt:[]	
#VaccineMurder	murder:[]	vaccine:[]	
#RoevWade	roev:[]	wade:[]	
#PaidVaxMediaScum	paid:[]	media:[]	vax:[]	scum:[]	
#CoerciveControl	coercive:[]	control:[]	
#GetVaccinatedUK	u:[]	get:[]	k:[]	vaccinated:[]	
#COVIDVaccineAccountability	vaccine:[]	c:[]	d:[]	v:[]	i:[]	accountability:[]	o:[]	
#TogetherWeWin	win:[]	we:[]	together:[]	
#WuhanF	wuhan:[]	f:[]	
#InternationalTravelRisks	risks:[]	travel:[]	international:[]	
#StandUpToPower	power:[]	to:[]	up:[]	stand:[]	
#ShameOnGermany	shame:[]	germany:[]	on:[]	
#ItWas	was:[]	it:[]	
#MoronicV	moronic:[]	v:[]	
#WhatsNext	next:[]	whats:[]	
#NoLockdown	no:[]	lockdown:[]	
#CovidMisinformation	covid:[]	misinformation:[]	
#BlockchainFascism	blockchain:[]	fascism:[]	
#StopTheClotShot	clot:[]	the:[]	stop:[]	shot:[]	
#NomoreEmergencyPowers	nomore:[]	emergency:[]	powers:[]	
#FarLeft	left:[]	far:[]	
#ItalianDictatorship	italian:[]	dictatorship:[]	
#LeftLockdownScepticsMeet	meet:[]	left:[]	lockdown:[]	sceptics:[]	
#AustraliaOne	one:[]	australia:[]	
#IStandWithEricClapton	with:[]	clapton:[]	eric:[]	i:[]	stand:[]	
#ShameOnNaziGermany	nazi:[]	shame:[]	germany:[]	on:[]	
#NoneCompliance	compliance:[]	none:[]	
#PuydeDome	puyde:[]	dome:[]	
#NoVaccineMandatesAnywhere	no:[]	vaccine:[]	mandates:[]	anywhere:[]	
#ThankYouBiden	biden:[]	thank:[]	you:[]	
#NoVaccinesPassportsAnywhere	no:[]	vaccines:[]	passports:[]	anywhere:[]	
#VaccineInjury	vaccine:[]	injury:[]	
#RemoveUrsulaVonderLeyen	vonder:[]	ursula:[]	leyen:[]	remove:[]	
#StopTestingChildren	stop:[]	children:[]	testing:[]	
#PedsICU	peds:[]	c:[]	u:[]	i:[]	
#NewNormal	normal:[]	new:[]	
#DemocratsHateAmerica	democrats:[]	hate:[]	america:[]	
#CCPVirus	p:[]	c:[]	virus:[]	
#DefyBrandon	brandon:[]	defy:[]	
#NoHealthPass	no:[]	pass:[]	health:[]	
#NoNutNovember	november:[]	no:[]	nut:[]	
#GlobalistTraitorDonnelly	traitor:[]	donnelly:[]	globalist:[]	
#QuestionAuthority	question:[]	authority:[]	
#DrGlynn	glynn:[]	dr:[]	
#HeGetsIt	it:[]	gets:[]	he:[]	
#TakeOffYourPoppy	take:[]	poppy:[]	your:[]	off:[]	
#LetsGoBr	br:[]	go:[]	lets:[]	
#COVIDBoosterShots	c:[]	d:[]	v:[]	i:[]	shots:[]	booster:[]	o:[]	
#DanAndrews	dan:[]	andrews:[]	
#NoMandatoryVaccines	no:[]	vaccines:[]	mandatory:[]	
#NorthernIreland	northern:[]	ireland:[]	
#SlipperySlopeToHell	to:[]	slope:[]	hell:[]	slippery:[]	
#FollowTheMoney	the:[]	money:[]	follow:[]	
#vaccineExposed	vaccine:[]	exposed:[]	
#NotOnTheNews	news:[]	the:[]	not:[]	on:[]	
#PeneraBread	bread:[]	penera:[]	
#DeathByPolititian	death:[]	by:[]	polititian:[]	
#BorisIsFinished	boris:[]	finished:[]	is:[]	
#ThisHill	hill:[]	this:[]	
#LeSnitch	snitch:[]	le:[]	
#BaudetHeeftGelijk	baudet:[]	gelijk:[]	heeft:[]	
#AntiSemitism	semitism:[]	anti:[]	
#mandatoryVaccination	mandatory:[]	vaccination:[]	
#NewYorkNadia	new:[]	nadia:[]	york:[]	
#VannesaGelman	gelman:[]	vannesa:[]	
#EricCla	eric:[]	cla:[]	
#SustainableDevelopmentGoals	development:[]	sustainable:[]	goals:[]	
#ErinOtoole	erin:[]	otoole:[]	
#HoldTheLin	lin:[]	the:[]	hold:[]	
#PandemicOfCorruption	of:[]	pandemic:[]	corruption:[]	
#NonAu	au:[]	non:[]	
#UnifiedNonCompliance	compliance:[]	unified:[]	non:[]	
#NayibBukele	nayib:[]	bukele:[]	
#ThankYouBrandon	brandon:[]	thank:[]	you:[]	
#SocialEngeneering	engeneering:[]	social:[]	
#VFDraghi	f:[]	v:[]	draghi:[]	
#ScamDemic	demic:[]	scam:[]	
#TaxationIsTheft	is:[]	theft:[]	taxation:[]	
#AustraliaHasFallen	fallen:[]	australia:[]	has:[]	
#strandedAussies	stranded:[]	aussies:[]	
#FoxyFauci	foxy:[]	fauci:[]	
#DeBl	de:[]	bl:[]	
#AustriaMustNotFall	not:[]	fall:[]	must:[]	austria:[]	
#VoteThemAllOut	all:[]	them:[]	vote:[]	out:[]	
#NFLTwitter	twitter:[]	f:[]	l:[]	n:[]	
#CentralPark	central:[]	park:[]	
#NickFuentes	nick:[]	fuentes:[]	
#BlackLivesMatter	lives:[]	black:[]	matter:[]	
#WeAreWINNING	are:[]	g:[]	w:[]	i:[]	n:[]	we:[]	
#UnitedNations	united:[]	nations:[]	
#YoursHasToxins	toxins:[]	has:[]	yours:[]	
#BearsFans	bears:[]	fans:[]	
#FakeNews	news:[]	fake:[]	
#PurpleArmy	army:[]	purple:[]	
#NoNHSMandates	no:[]	s:[]	h:[]	mandates:[]	n:[]	
#WeMustResist	resist:[]	must:[]	we:[]	
#VaccineGenocide	vaccine:[]	genocide:[]	
#NoLockdownForUnvaccinated	no:[]	unvaccinated:[]	for:[]	lockdown:[]	
#PredatorProducer	predator:[]	producer:[]	
#BorisJohnWorstPMever	p:[]	mever:[]	boris:[]	worst:[]	john:[]	
#JailScottMorrison	jail:[]	scott:[]	morrison:[]	
#TheGreatAwakening	the:[]	awakening:[]	great:[]	
#ZombieLove	love:[]	zombie:[]	
#DavosSecrets	davos:[]	secrets:[]	
#NuVariante	variante:[]	nu:[]	
#RodStewart	stewart:[]	rod:[]	
#StayStrong	strong:[]	stay:[]	
#NoMandatedFirings	firings:[]	no:[]	mandated:[]	
#NewYears	new:[]	years:[]	
#HistoryRepeatingItself	itself:[]	repeating:[]	history:[]	
#ScienceDeniers	science:[]	deniers:[]	
#MorningLive	live:[]	morning:[]	
#LongCovid	covid:[]	long:[]	
#EUFluDay	u:[]	e:[]	day:[]	flu:[]	
#DowningStreetBriefing	street:[]	downing:[]	briefing:[]	
#HistoryRepeats	repeats:[]	history:[]	
#CovidPassport	covid:[]	passport:[]	
#FordfailedOntario	fordfailed:[]	ontario:[]	
#QuestionEverything	question:[]	everything:[]	
#ClimateC	c:[]	climate:[]	
#GoHomeBillGates	gates:[]	go:[]	bill:[]	home:[]	
#whiteSupremacists	supremacists:[]	white:[]	
#FuelPriceHike	price:[]	fuel:[]	hike:[]	
#NOLists	lists:[]	n:[]	o:[]	
#PrGuy	pr:[]	guy:[]	
#GlobalNonCompliance	compliance:[]	global:[]	non:[]	
#WillNotComply	not:[]	comply:[]	will:[]	
#TruthMatters	truth:[]	matters:[]	
#ArrestMarkAndrews	arrest:[]	andrews:[]	mark:[]	
#NonAuPassDeLaHonte	de:[]	au:[]	honte:[]	la:[]	pass:[]	non:[]	
#ImHealthy	im:[]	healthy:[]	
#CovidHoax	covid:[]	hoax:[]	
#SOSfromAustrali	australi:[]	s:[]	sfrom:[]	o:[]	
#COVIDVaccine	vaccine:[]	c:[]	d:[]	v:[]	i:[]	o:[]	
#MRNAVaccines	a:[]	r:[]	vaccines:[]	m:[]	n:[]	
#RepublicansHateScience	republicans:[]	science:[]	hate:[]	
#PlannedNonsense	planned:[]	nonsense:[]	
#NewSpeak	new:[]	speak:[]	
#MoreOfThis	more:[]	of:[]	this:[]	
#FauciLiedPeopleDi	di:[]	fauci:[]	people:[]	lied:[]	
#NoVaccines	no:[]	vaccines:[]	
#NetworkAnalysis	analysis:[]	network:[]	
#TheVirusParty	the:[]	virus:[]	party:[]	
#WeWillNOTcomply	tcomply:[]	will:[]	n:[]	we:[]	o:[]	
#CovidVaccineKills	kills:[]	vaccine:[]	covid:[]	
#CalmDown	calm:[]	down:[]	
#CoronaVaccine	vaccine:[]	corona:[]	
#MeToo	too:[]	me:[]	
#NewYorkCity	new:[]	city:[]	york:[]	
#HowardSprings	springs:[]	howard:[]	
#NoMoreAbuse	no:[]	abuse:[]	more:[]	
#BackThe	the:[]	back:[]	
#NonAuVaccinObligatoire	vaccin:[]	au:[]	obligatoire:[]	non:[]	
#DontBuyFromDischem	dischem:[]	buy:[]	from:[]	dont:[]	
#COVIDVaccination	c:[]	d:[]	v:[]	i:[]	vaccination:[]	o:[]	
#BorisHasFailedTheNation	the:[]	nation:[]	boris:[]	failed:[]	has:[]	
#FoodShortages	shortages:[]	food:[]	
#NoCRT	no:[]	r:[]	c:[]	t:[]	
#PayAttention	attention:[]	pay:[]	
#CPCNonsense	p:[]	c:[]	nonsense:[]	
#EarlyTreatment	treatment:[]	early:[]	
#BykUyanBornova	byk:[]	uyan:[]	bornova:[]	
#MedTwi	twi:[]	med:[]	
#BrooklynNets	nets:[]	brooklyn:[]	
#SolidaritywithLithuania	lithuania:[]	solidaritywith:[]	
#TheRealAnthonyFauci	the:[]	fauci:[]	real:[]	anthony:[]	
#NoFear	no:[]	fear:[]	
#AltersDNA	a:[]	alters:[]	d:[]	n:[]	
#fireBonnie	bonnie:[]	fire:[]	
#AskingForAFriend	a:[]	asking:[]	friend:[]	for:[]	
#SayNoToBillGates	gates:[]	no:[]	bill:[]	say:[]	to:[]	
#GoScience	science:[]	go:[]	
#ShitCharlie	shit:[]	charlie:[]	
#NavyWife	navy:[]	wife:[]	
#KillTheBill	the:[]	bill:[]	kill:[]	
#BritishTV	t:[]	v:[]	british:[]	
#DansLockoutFail	fail:[]	lockout:[]	dans:[]	
#NoMedicalFascism	no:[]	medical:[]	fascism:[]	
#nogreenpaSS	nogreenpa:[]	s:[]	
#NotMyCanada	not:[]	canada:[]	my:[]	
#OAPAbuse	p:[]	a:[]	abuse:[]	o:[]	
#NoVaccineP	p:[]	no:[]	vaccine:[]	
#NoVaccineM	no:[]	vaccine:[]	m:[]	
#QRweigeraar	q:[]	rweigeraar:[]	
#MDAnderson	d:[]	anderson:[]	m:[]	
#NoMoreFakeNews	news:[]	no:[]	more:[]	fake:[]	
#VaccineEconomics	economics:[]	vaccine:[]	
#ElectionDay	election:[]	day:[]	
#SNPs	ps:[]	s:[]	n:[]	
#YouTube	tube:[]	you:[]	
#NoVaccinePassportAnywhere	no:[]	vaccine:[]	passport:[]	anywhere:[]	
#BonnieHenrys	henrys:[]	bonnie:[]	
#CoronaViru	viru:[]	corona:[]	
#HappyHalloween	halloween:[]	happy:[]	
#NoVaccinePassportsForWales	no:[]	vaccine:[]	for:[]	wales:[]	passports:[]	
#ThankYou	thank:[]	you:[]	
#boycottMSM	s:[]	boycott:[]	m:[]	
#FcukOffHolohan	holohan:[]	fcuk:[]	off:[]	
#CovidGesetzNein	covid:[]	gesetz:[]	nein:[]	
#COVIDisCommunism	c:[]	v:[]	i:[]	communism:[]	dis:[]	o:[]	
#italiaNONmolla	italia:[]	nmolla:[]	n:[]	o:[]	
#CyrilMustGo	cyril:[]	go:[]	must:[]	
#GetABooster	a:[]	get:[]	booster:[]	
#WearMasks	wear:[]	masks:[]	
#NoMaskMandates	no:[]	mandates:[]	mask:[]	
#ItEnd	end:[]	it:[]	
#CorporateManslaughter	corporate:[]	manslaughter:[]	
#NaziNPHET	p:[]	nazi:[]	t:[]	e:[]	h:[]	n:[]	
#mRNA	a:[]	r:[]	m:[]	n:[]	
#NoplanB	b:[]	noplan:[]	
#HelpOthersGetVacci	help:[]	vacci:[]	get:[]	others:[]	
#ArrestTrumpNow	trump:[]	arrest:[]	now:[]	
#NoBailForBillGates	gates:[]	no:[]	for:[]	bill:[]	bail:[]	
#StandWithKyrie	with:[]	kyrie:[]	stand:[]	
#AlexanderSchallenberg	schallenberg:[]	alexander:[]	
#LiberalProgressives	progressives:[]	liberal:[]	
#VaccineDeaths	vaccine:[]	deaths:[]	
#FlyLess	fly:[]	less:[]	
#NoTyranny	no:[]	tyranny:[]	
#AntiMask	mask:[]	anti:[]	
#CanadaHasFallen	fallen:[]	canada:[]	has:[]	
#NotAboutHealth	not:[]	about:[]	health:[]	
#WienRuft	ruft:[]	wien:[]	
#CovidW	covid:[]	w:[]	
#ArrestBillGates	gates:[]	arrest:[]	bill:[]	
#VaccineRolloutSA	a:[]	vaccine:[]	s:[]	rollout:[]	
#PutKidsst	kidsst:[]	put:[]	
#ModernDayTyranny	tyranny:[]	modern:[]	day:[]	
#ClimateEmergency	emergency:[]	climate:[]	
#RTEFakeNews	news:[]	r:[]	t:[]	e:[]	fake:[]	
#NursingHomeGenocide	genocide:[]	nursing:[]	home:[]	
#StandToGether	gether:[]	to:[]	stand:[]	
#WearaDamnMask	damn:[]	weara:[]	mask:[]	
#Corrupt#SajidJavid	corrupt:[]	sajid:[]	javid:[]	
#BornBFree	b:[]	born:[]	free:[]	
#InThisTogether	in:[]	this:[]	together:[]	
#disbandNphet	nphet:[]	disband:[]	
#noID	no:[]	d:[]	i:[]	
#WashYourHands	hands:[]	wash:[]	your:[]	
#DeBlasioTookOurPay	took:[]	de:[]	blasio:[]	pay:[]	our:[]	
#YouAreNotAlone	alone:[]	not:[]	are:[]	you:[]	
#LiberalismIsAMentalDisorder	a:[]	liberalism:[]	disorder:[]	mental:[]	is:[]	
#BillgatesIsEvil	billgates:[]	is:[]	evil:[]	
#TakeAmericaBack	take:[]	back:[]	america:[]	
#NoPassports	no:[]	passports:[]	
#WalkingBrainDead	walking:[]	dead:[]	brain:[]	
#ArrestThemAll	all:[]	arrest:[]	them:[]	
#ResignSturgeon	sturgeon:[]	resign:[]	
#WideAwake	wide:[]	awake:[]	
#LetsG	g:[]	lets:[]	
#NoVaccinePassportAnywh	no:[]	vaccine:[]	passport:[]	anywh:[]	
#MunchausensByProxy	proxy:[]	by:[]	munchausens:[]	
#NoToCovidChildrenVaccine	no:[]	vaccine:[]	covid:[]	children:[]	to:[]	
#digitalIdentity	digital:[]	identity:[]	
#COVIDIOTs	c:[]	d:[]	v:[]	i:[]	ts:[]	o:[]	
#OpNazi	nazi:[]	op:[]	
#StopLine	stop:[]	line:[]	
#TraderJoes	joes:[]	trader:[]	
#StopKillingKids	stop:[]	killing:[]	kids:[]	
#AustraliaHASFALLEN	a:[]	s:[]	e:[]	f:[]	h:[]	australia:[]	l:[]	n:[]	
#auspoI	auspo:[]	i:[]	
#NeverVoteC	never:[]	c:[]	vote:[]	
#QRc	rc:[]	q:[]	
#CatholicTwitter	twitter:[]	catholic:[]	
#VaccinationsSaveLives	lives:[]	vaccinations:[]	save:[]	
#LiamJones	liam:[]	jones:[]	
#BeLikeAustria	be:[]	like:[]	austria:[]	
#BigStop	big:[]	stop:[]	
#EnoughCOVIDBullshit	c:[]	d:[]	v:[]	i:[]	enough:[]	bullshit:[]	o:[]	
#FoxAndFriends	and:[]	friends:[]	fox:[]	
#EnforceTheSubpoenas	the:[]	enforce:[]	subpoenas:[]	
#ThisIsTheirShot	this:[]	their:[]	is:[]	shot:[]	
#CanYou	can:[]	you:[]	
#VaccinesWork	vaccines:[]	work:[]	
#SteveBannon	steve:[]	bannon:[]	
#VaccineTyranny	vaccine:[]	tyranny:[]	
#StandWithPerth	with:[]	perth:[]	stand:[]	
#IrelandsFittestFamily	fittest:[]	irelands:[]	family:[]	
#PasseSanitaire	sanitaire:[]	passe:[]	
#SexWork	work:[]	sex:[]	
#NoMand	no:[]	mand:[]	
#EvilBillGates	gates:[]	bill:[]	evil:[]	
#FreeEU	u:[]	e:[]	free:[]	
#MyBodyMyCho	cho:[]	body:[]	my:[]	
#DeBlasio	de:[]	blasio:[]	
#EUGangsters	gangsters:[]	u:[]	e:[]	
#ForoNoVacunadosRD	vacunados:[]	no:[]	r:[]	d:[]	foro:[]	
#MassVaccination	mass:[]	vaccination:[]	
#WarRoomShow	show:[]	war:[]	room:[]	
#triesteNONmol	trieste:[]	n:[]	nmol:[]	o:[]	
#DictatorBiden	biden:[]	dictator:[]	
#AldiBoycott	boycott:[]	aldi:[]	
#COVIDVaccines	c:[]	d:[]	vaccines:[]	v:[]	i:[]	o:[]	
#BSCGemsAlert	b:[]	c:[]	s:[]	gems:[]	alert:[]	
#ComeOnEngland	england:[]	come:[]	on:[]	
#PoopyBiden	biden:[]	poopy:[]	
#IStandWithSouthwestEm	southwest:[]	with:[]	em:[]	i:[]	stand:[]	
#ArrestFauci	arrest:[]	fauci:[]	
#ResistanceIsVictory	victory:[]	is:[]	resistance:[]	
#NonAuPasseDeL	de:[]	au:[]	l:[]	passe:[]	non:[]	
#CarbonCon	con:[]	carbon:[]	
#DigitalCertificate	digital:[]	certificate:[]	
#CallAction	call:[]	action:[]	
#EstherRantzen	esther:[]	rantzen:[]	
#whiteSupremacy	white:[]	supremacy:[]	
#StrongerTogether	stronger:[]	together:[]	
#NoManda	no:[]	manda:[]	
#GodBlessTexas	texas:[]	bless:[]	god:[]	
#VaxChamp	champ:[]	vax:[]	
#MedicalDiscrimination	medical:[]	discrimination:[]	
#NoForcedVaccination	no:[]	forced:[]	vaccination:[]	
#TheGreatGlob	the:[]	glob:[]	great:[]	
#deBlasio	de:[]	blasio:[]	
#BoosterVaccine	vaccine:[]	booster:[]	
#PfizerLeak	leak:[]	pfizer:[]	
#AmericaFirst	first:[]	america:[]	
#EnoughIsEno	eno:[]	is:[]	enough:[]	
#StandWithYou	with:[]	stand:[]	you:[]	
#DefundTheBBC	the:[]	b:[]	defund:[]	c:[]	
#EUFail	fail:[]	u:[]	e:[]	
#NoVaccineDiscrimination	no:[]	vaccine:[]	discrimination:[]	
#NoTesting	no:[]	testing:[]	
#NOVaccineMandate	mandate:[]	vaccine:[]	n:[]	o:[]	
#COVIDvaccines	c:[]	dvaccines:[]	v:[]	i:[]	o:[]	
#JeanCastex	jean:[]	castex:[]	
#CovidVaccinesideeffects	vaccinesideeffects:[]	covid:[]	
#JustSayNo#DoNotComply	no:[]	not:[]	comply:[]	say:[]	do:[]	just:[]	
#OpenForAll	all:[]	for:[]	open:[]	
#ItsNotaVaccine	vaccine:[]	its:[]	nota:[]	
#RejectNWO	reject:[]	w:[]	n:[]	o:[]	
#FucktheGreatReset	fuckthe:[]	reset:[]	great:[]	
#ChoiceYo	yo:[]	choice:[]	
#TravisTritt	tritt:[]	travis:[]	
#PainChampion	pain:[]	champion:[]	
#MarilynGladue	marilyn:[]	gladue:[]	
#CreepyJoe	joe:[]	creepy:[]	
#GlobalGoverment	goverment:[]	global:[]	
#CovidVaccineinjury	covid:[]	vaccineinjury:[]	
#ChildreninNeed	need:[]	childrenin:[]	
#PsychoPath	path:[]	psycho:[]	
#UnitedWeWin	united:[]	win:[]	we:[]	
#AboriginalHumanRights	rights:[]	aboriginal:[]	human:[]	
#ShadowGovernments	shadow:[]	governments:[]	
#WeAreStillBeingLiedTo	still:[]	are:[]	to:[]	being:[]	lied:[]	we:[]	
#WeDoNo	no:[]	do:[]	we:[]	
#ItalianPM	p:[]	italian:[]	m:[]	
#EnoughSaid	enough:[]	said:[]	
#ShameOnYouBorisJohnson	shame:[]	boris:[]	johnson:[]	you:[]	on:[]	
#TheEnd	the:[]	end:[]	
#SellOut	sell:[]	out:[]	
#JustinTrudeau	trudeau:[]	justin:[]	
#ImWithCOVID	with:[]	c:[]	d:[]	im:[]	v:[]	i:[]	o:[]	
#SNPlies	s:[]	plies:[]	n:[]	
#GregReese	reese:[]	greg:[]	
#BadFirefighters	bad:[]	firefighters:[]	
#KristaFord	krista:[]	ford:[]	
#ProtectYourFreedom	freedom:[]	your:[]	protect:[]	
#OpenUp	up:[]	open:[]	
#CancerCenter	center:[]	cancer:[]	
#PennyDropped	dropped:[]	penny:[]	
#DoNotConsent	not:[]	do:[]	consent:[]	
#NoPCRTesting	p:[]	no:[]	r:[]	c:[]	testing:[]	
#OntarioFi	fi:[]	ontario:[]	
#MakeCourageTheVirus	the:[]	virus:[]	make:[]	courage:[]	
##NoVaccinePassports	no:[]	vaccine:[]	passports:[]	
#KangarooCourtofAustralia	kangaroo:[]	australia:[]	courtof:[]	
#CristianTerhes	terhes:[]	cristian:[]	
#ScottishGovernment	government:[]	scottish:[]	
#UnitedNo	no:[]	united:[]	
#CognitiveDissonance	cognitive:[]	dissonance:[]	
#NoMedicalA	a:[]	no:[]	medical:[]	
#VaccinesNotLaw	not:[]	law:[]	vaccines:[]	
#DeleteTheApp	app:[]	the:[]	delete:[]	
#DoNotComplyEver	ever:[]	not:[]	comply:[]	do:[]	
#ImWithKyrie	with:[]	im:[]	kyrie:[]	
#UnitedKingdom	united:[]	kingdom:[]	
#MaskOFF	f:[]	o:[]	mask:[]	
#RodgersResearch	rodgers:[]	research:[]	
#GBNews	news:[]	b:[]	g:[]	
#PopeFrancis	pope:[]	francis:[]	
#UnVaxxed	vaxxed:[]	un:[]	
#TheyAreFewWeAreMany	are:[]	few:[]	many:[]	we:[]	they:[]	
#RiseUpMelbourne	up:[]	rise:[]	melbourne:[]	
#NoDGC	no:[]	c:[]	d:[]	g:[]	
#ThankYouScience	science:[]	thank:[]	you:[]	
#VaccinateTheWorld	the:[]	vaccinate:[]	world:[]	
#NorthernTerritory	northern:[]	territory:[]	
#SovereignCitizens	sovereign:[]	citizens:[]	
#JohnMurphy	murphy:[]	john:[]	
#NotJustAGreekLetter	greek:[]	a:[]	not:[]	letter:[]	just:[]	
#PengShuai	peng:[]	shuai:[]	
#CovidJab	covid:[]	jab:[]	
#GetV	v:[]	get:[]	
#MedicalAp	medical:[]	ap:[]	
#CoronavirusUpdates	coronavirus:[]	updates:[]	
#stopCoercion	stop:[]	coercion:[]	
#FreedomRaly	freedom:[]	raly:[]	
#DrPredragKon	predrag:[]	kon:[]	dr:[]	
#TeamSurrender	team:[]	surrender:[]	
#BlueLivesMatter	lives:[]	blue:[]	matter:[]	
#LeaveOurKidsAlo	alo:[]	leave:[]	our:[]	kids:[]	
#ThisPivotalMoment	pivotal:[]	this:[]	moment:[]	
#EndScamdemic	scamdemic:[]	end:[]	
#AngelaMerkel	angela:[]	merkel:[]	
#HaraldWalach	harald:[]	walach:[]	
#FLSpecialSession	special:[]	session:[]	f:[]	l:[]	
#VoteConservative	conservative:[]	vote:[]	
#LetGoBrandon	brandon:[]	go:[]	let:[]	
#NoMedicalApartheid	no:[]	medical:[]	apartheid:[]	
#CivilRights	rights:[]	civil:[]	
#ChildrenDay	children:[]	day:[]	
#SwissReferendum	swiss:[]	referendum:[]	
#NoMasksInClass	no:[]	in:[]	masks:[]	class:[]	
#TripleVaxxed	vaxxed:[]	triple:[]	
#DansNext	next:[]	dans:[]	
#PlagueSpreader	spreader:[]	plague:[]	
#ProudNotToBeBrainwashed	brainwashed:[]	not:[]	be:[]	proud:[]	to:[]	
#IBACDan	dan:[]	a:[]	b:[]	c:[]	i:[]	
#SayNo	no:[]	say:[]	
#IWillN	will:[]	i:[]	n:[]	
#WhiteSupremacist	supremacist:[]	white:[]	
#ColinPowell	colin:[]	powell:[]	
#BoostedBaybee	baybee:[]	boosted:[]	
#BeConsiderate	be:[]	considerate:[]	
#DavidIcke	icke:[]	david:[]	
#EmptyShelvesJoe	joe:[]	shelves:[]	empty:[]	
#NoVaccinePassp	no:[]	vaccine:[]	passp:[]	
#ImACelebrity	celebrity:[]	a:[]	im:[]	
#DeepState	deep:[]	state:[]	
#UnitedStatesOfAmerica	united:[]	of:[]	america:[]	states:[]	
#HoC	c:[]	ho:[]	
#NoVaccinePasspor	no:[]	vaccine:[]	passpor:[]	
#AviBarak	avi:[]	barak:[]	
#SayNO	say:[]	n:[]	o:[]	
#RonDeSantis	ron:[]	de:[]	santis:[]	
#NYCMayor	c:[]	mayor:[]	y:[]	n:[]	
#NOVaccineMandates	vaccine:[]	mandates:[]	n:[]	o:[]	
#StoptheMandates	stopthe:[]	mandates:[]	
#LegalFiction	fiction:[]	legal:[]	
#ValueLife	value:[]	life:[]	
#WakeUpNow	wake:[]	now:[]	up:[]	
#MediaLies	lies:[]	media:[]	
#SayYesToFreedoms	yes:[]	say:[]	freedoms:[]	to:[]	
#LetsGoBiden	biden:[]	go:[]	lets:[]	
#StaceyAbrams	abrams:[]	stacey:[]	
#NonAuPas	pas:[]	au:[]	non:[]	
#SaveOurChi	chi:[]	save:[]	our:[]	
#OmicronVariant	omicron:[]	variant:[]	
#UnitedNonCompliance	united:[]	compliance:[]	non:[]	
#CrimeAgainstHumanity	against:[]	crime:[]	humanity:[]	
#ProtectYourChildren	children:[]	your:[]	protect:[]	
#vaccineDeaths	vaccine:[]	deaths:[]	
#MyShotHasBullets	has:[]	my:[]	bullets:[]	shot:[]	
#StopCoer	stop:[]	coer:[]	
#AmericanAirlines	airlines:[]	american:[]	
#RTEpt	r:[]	t:[]	ept:[]	
#HateDivides	divides:[]	hate:[]	
#CommunistCanada	communist:[]	canada:[]	
#VaccinesAll	all:[]	vaccines:[]	
#GoonSquad	squad:[]	goon:[]	
#lbsoffGuy	lbsoff:[]	guy:[]	
#VaxExposed	exposed:[]	vax:[]	
#TorySleeze	tory:[]	sleeze:[]	
#GreatAwakening	awakening:[]	great:[]	
#CovidAss	ass:[]	covid:[]	
#XiVariant	xi:[]	variant:[]	
#StopComplying	stop:[]	complying:[]	
#MyChildMyChoice	choice:[]	my:[]	child:[]	
#BankOfCanada	bank:[]	canada:[]	of:[]	
#OmicronInIndia	omicron:[]	in:[]	india:[]	
#RemoveSage	sage:[]	remove:[]	
#standToGether	gether:[]	to:[]	stand:[]	
#FreeUs	free:[]	us:[]	
#TheyreMockingUs	theyre:[]	us:[]	mocking:[]	
#TriumphofMary	triumphof:[]	mary:[]	
#LamorgeseDime	dime:[]	lamorgese:[]	
#MonstrousMonday	monstrous:[]	monday:[]	
#IDoNotConsent	not:[]	i:[]	do:[]	consent:[]	
#NoVaccineMa	no:[]	vaccine:[]	ma:[]	
#VaXxed	xxed:[]	va:[]	
#MengeleMandates	mengele:[]	mandates:[]	
#NoToVaccinePassports	no:[]	vaccine:[]	passports:[]	to:[]	
#BoycottAldi	boycott:[]	aldi:[]	
#ThisIsOurShot	this:[]	is:[]	our:[]	shot:[]	
#IrreversibleRoadmap	irreversible:[]	roadmap:[]	
#FreedomOfSpeech	freedom:[]	speech:[]	of:[]	
#TakeBackYourPower	take:[]	back:[]	power:[]	your:[]	
#SaveAmerica	save:[]	america:[]	
#FauciForPrison	for:[]	fauci:[]	prison:[]	
#WelshProtesters	protesters:[]	welsh:[]	
#ReinstateDarrenPlymouth	darren:[]	reinstate:[]	plymouth:[]	
#MarchForFreedom	freedom:[]	for:[]	march:[]	
#BoosterShot	booster:[]	shot:[]	
#NoMoreSilence	no:[]	more:[]	silence:[]	
#VaccinesSave	vaccines:[]	save:[]	
#ShoppersDougMart	doug:[]	mart:[]	shoppers:[]	
#FordMustResign	must:[]	ford:[]	resign:[]	
#DougFord	doug:[]	ford:[]	
#conspiracyTheory	conspiracy:[]	theory:[]	
#NoMoreFear	no:[]	more:[]	fear:[]	
#COVIDVaccineKids	vaccine:[]	c:[]	d:[]	v:[]	i:[]	kids:[]	o:[]	
#PandemicOfSelfOverOthers	over:[]	of:[]	self:[]	pandemic:[]	others:[]	
#UnitedAgainstVaxPassports	united:[]	against:[]	passports:[]	vax:[]	
#NoVaccineMandat	no:[]	vaccine:[]	mandat:[]	
#DigitalCurrency	digital:[]	currency:[]	
#SackMichie	sack:[]	michie:[]	
#AskNotorious	notorious:[]	ask:[]	
#PCRtestFraud	p:[]	c:[]	fraud:[]	rtest:[]	
#DonLemon	lemon:[]	don:[]	
#NoPass	no:[]	pass:[]	
#NoGreenPass	no:[]	green:[]	pass:[]	
#NoMoreSesemeStreet	no:[]	street:[]	more:[]	seseme:[]	
#ArrestVallance	arrest:[]	vallance:[]	
#VoetsekANC	a:[]	c:[]	n:[]	voetsek:[]	
#ConservativeCommunistParty	communist:[]	conservative:[]	party:[]	
#ThePowerOfN	the:[]	of:[]	power:[]	n:[]	
#NoVaccinePa	pa:[]	no:[]	vaccine:[]	
#JavidOut	javid:[]	out:[]	
#HealthR	r:[]	health:[]	
#GetVaccinatedASAP	p:[]	a:[]	s:[]	get:[]	vaccinated:[]	
#NiceTryPRguy	p:[]	try:[]	rguy:[]	nice:[]	
#CovidHOAX	a:[]	covid:[]	x:[]	h:[]	o:[]	
#SocialDistancing	social:[]	distancing:[]	
#CivilDisobedience	disobedience:[]	civil:[]	
#NoShots	no:[]	shots:[]	
#UnitednonCompliance	compliance:[]	unitednon:[]	
#VoteBlue	blue:[]	vote:[]	
#MikeAdams	adams:[]	mike:[]	
#ThanksBrandon	thanks:[]	brandon:[]	
#ChoiceNotUnemployment	not:[]	unemployment:[]	choice:[]	
#MarkDrakefordOut	drakeford:[]	mark:[]	out:[]	
#CovidWasAnInsideJob	covid:[]	was:[]	job:[]	inside:[]	an:[]	
#DictatorDan	dan:[]	dictator:[]	
#VoteEarly	vote:[]	early:[]	
#DictatureSanitaire	dictature:[]	sanitaire:[]	
#DoNotCo	not:[]	do:[]	co:[]	
#NoSocialCredit	no:[]	social:[]	credit:[]	
#ImpfPaSS	pa:[]	s:[]	impf:[]	
#FourthWave	fourth:[]	wave:[]	
#ChinaStyle	china:[]	style:[]	
#VaxHa	ha:[]	vax:[]	
#PerthFreedomMarch	freedom:[]	perth:[]	march:[]	
#stayhomeDecst	stayhome:[]	decst:[]	
#VaccineAdverseEff	vaccine:[]	eff:[]	adverse:[]	
#StandAgainstFascism	against:[]	fascism:[]	stand:[]	
#ItWa	wa:[]	it:[]	
#BelieveWom	wom:[]	believe:[]	
#ShameAndShun	shame:[]	and:[]	shun:[]	
#SlavePassports	slave:[]	passports:[]	
#SanitarySegregation	sanitary:[]	segregation:[]	
#SteveBaker	steve:[]	baker:[]	
#CovidVaccines	covid:[]	vaccines:[]	
#BloodCleanNoVaccine	no:[]	vaccine:[]	clean:[]	blood:[]	
#HeartAndHustle	and:[]	hustle:[]	heart:[]	
#ClownWorld	world:[]	clown:[]	
#BuildBackBette	build:[]	bette:[]	back:[]	
#LetIrelandLive	let:[]	live:[]	ireland:[]	
#WeAreONE	e:[]	are:[]	n:[]	we:[]	o:[]	
#OpenDebate	debate:[]	open:[]	
#StopDansEnablingAct	enabling:[]	act:[]	stop:[]	dans:[]	
#SayNoToVaccineMandate	no:[]	mandate:[]	vaccine:[]	say:[]	to:[]	
#OmicronIsHere	here:[]	omicron:[]	is:[]	
#VaccineMandate	mandate:[]	vaccine:[]	
#NHSJabs	s:[]	h:[]	jabs:[]	n:[]	
#ArrestPatKenny	pat:[]	arrest:[]	kenny:[]	
#NHSk	sk:[]	h:[]	n:[]	
#GordonBrown	brown:[]	gordon:[]	
#NoToMandat	no:[]	mandat:[]	to:[]	
#LondonProtest	london:[]	protest:[]	
#AustrianPolice	police:[]	austrian:[]	
#InfoWars	wars:[]	info:[]	
#StopTheBullying	the:[]	stop:[]	bullying:[]	
#SenatorAlexAntic	senator:[]	alex:[]	antic:[]	
#GetCovidTested	covid:[]	tested:[]	get:[]	
#FBRParty	r:[]	b:[]	f:[]	party:[]	
#ClimateAction	action:[]	climate:[]	
#FraudNation	nation:[]	fraud:[]	
#CrimesAgain	crimes:[]	again:[]	
#HouseofLords	lords:[]	houseof:[]	
#EndPolio	end:[]	polio:[]	
#TacoTuesday	tuesday:[]	taco:[]	
#PostAMask	a:[]	post:[]	mask:[]	
#HandsOffKids	hands:[]	off:[]	kids:[]	
#NoToVaccineMandates	no:[]	vaccine:[]	mandates:[]	to:[]	
#LeamingtonSpa	spa:[]	leamington:[]	
#GlobalReset	reset:[]	global:[]	
#CDCIsBigPharma	big:[]	c:[]	d:[]	is:[]	pharma:[]	
#VaccineInjuries	vaccine:[]	injuries:[]	
#WheresGavin	wheres:[]	gavin:[]	
#FakeBidenAdminisration	biden:[]	adminisration:[]	fake:[]	
#NoVaccineMandates	no:[]	vaccine:[]	mandates:[]	
#DivvyDevi	divvy:[]	devi:[]	
#JohnsonTheLiar	the:[]	liar:[]	johnson:[]	
#COVIDAus	c:[]	d:[]	v:[]	i:[]	aus:[]	o:[]	
#NoMandator	mandator:[]	no:[]	
#NoMandatoryMasks	no:[]	masks:[]	mandatory:[]	
#NoCBDC	no:[]	b:[]	c:[]	d:[]	
#GovernmentOverreach	government:[]	overreach:[]	
#NationalCabinet	national:[]	cabinet:[]	
#ToriesOut	tories:[]	out:[]	
#gopDeathCult	cult:[]	death:[]	gop:[]	
#FearFactory	factory:[]	fear:[]	
#ToryShambles	tory:[]	shambles:[]	
#IStandWithCinemaCoSwansea	with:[]	swansea:[]	i:[]	cinema:[]	co:[]	stand:[]	
#NoCovidPaSS	pa:[]	no:[]	covid:[]	s:[]	
#GlobalistPuppets	puppets:[]	globalist:[]	
#MedicalApartheid	medical:[]	apartheid:[]	
#GeneTherapy	gene:[]	therapy:[]	
#TheGreatGlobalPushb	the:[]	pushb:[]	global:[]	great:[]	
#SaveTheNHS	the:[]	s:[]	h:[]	save:[]	n:[]	
#FailedState	state:[]	failed:[]	
#GetVaccina	vaccina:[]	get:[]	
#NotApproved	approved:[]	not:[]	
#StandUnited	united:[]	stand:[]	
#NoToMandatoryVaccine	no:[]	vaccine:[]	to:[]	mandatory:[]	
#LeaveOurChildrenAlone	alone:[]	children:[]	leave:[]	our:[]	
#SocialCre	social:[]	cre:[]	
#CovidCamp	covid:[]	camp:[]	
#VaccineCertificates	vaccine:[]	certificates:[]	
#ImDone	im:[]	done:[]	
#WesternUniversity	university:[]	western:[]	
#FakeVaccine	vaccine:[]	fake:[]	
#WeAre	are:[]	we:[]	
#NoVaccinePassportsAny	no:[]	vaccine:[]	passports:[]	any:[]	
#NoDigitalID	digital:[]	no:[]	d:[]	i:[]	
#SaysNoToRyranny	no:[]	ryranny:[]	to:[]	says:[]	
#TheEmperorsNewClothes	the:[]	new:[]	emperors:[]	clothes:[]	
#SaturdayVibes	saturday:[]	vibes:[]	
#FreeToFly	fly:[]	to:[]	free:[]	
#WheresPete	pete:[]	wheres:[]	
#NoSocialCreditSystem	no:[]	system:[]	social:[]	credit:[]	
#LaGenteComeNoiNonMoll	moll:[]	la:[]	noi:[]	come:[]	gente:[]	non:[]	
#UKPlanB	b:[]	u:[]	k:[]	plan:[]	
#LeaveTheUnitedNations	the:[]	united:[]	leave:[]	nations:[]	
#PandemicofVaccinated	pandemicof:[]	vaccinated:[]	
#RemembranceDay	remembrance:[]	day:[]	
#LearnHistory	learn:[]	history:[]	
#MasksInSchool	school:[]	in:[]	masks:[]	
#SaveYourself	save:[]	yourself:[]	
#TongueOutTuesday	tuesday:[]	tongue:[]	out:[]	
#SpeakUp	speak:[]	up:[]	
#GetOffYourKnees	knees:[]	get:[]	your:[]	off:[]	
#VaxInjured	injured:[]	vax:[]	
#ReInstateBerniesTweet	instate:[]	re:[]	tweet:[]	bernies:[]	
#AmericanRescuePlan	american:[]	plan:[]	rescue:[]	
#MichelleNicoles	nicoles:[]	michelle:[]	
#WeAreThePercent	the:[]	are:[]	percent:[]	we:[]	
#TorontoPolic	toronto:[]	polic:[]	
#NeverWearAMask	a:[]	never:[]	wear:[]	mask:[]	
#NoDigitalPassports	digital:[]	no:[]	passports:[]	
#ClotShot	clot:[]	shot:[]	
#DoNotCom	com:[]	not:[]	do:[]	
#NoMandatoryVaccination	no:[]	mandatory:[]	vaccination:[]	
#ScamdemicIsOver	over:[]	scamdemic:[]	is:[]	
#LiarFromTheShire	the:[]	shire:[]	from:[]	liar:[]	
#WeWillNotCompl	not:[]	will:[]	compl:[]	we:[]	
#LiarJohnson	johnson:[]	liar:[]	
#EnoughIsEnough	is:[]	enough:[]	
#NatSec	sec:[]	nat:[]	
#NoForcedLockdowns	lockdowns:[]	no:[]	forced:[]	
#EndTryyany	tryyany:[]	end:[]	
#MYbodyMYch	ybody:[]	m:[]	ych:[]	
#FightForYourFreedom	freedom:[]	for:[]	your:[]	fight:[]	
#CDNPoli	c:[]	d:[]	poli:[]	n:[]	
#TyrannyInPlainSight	tyranny:[]	in:[]	plain:[]	sight:[]	
#HealthFreedom	freedom:[]	health:[]	
#IstandWithTheCarers	the:[]	with:[]	istand:[]	carers:[]	
#MoMoreLockdowns	lockdowns:[]	mo:[]	more:[]	
#GislaineMaxwelltrial	maxwelltrial:[]	gislaine:[]	
#VaxxersRemorse	vaxxers:[]	remorse:[]	
#PaidVaxPusher	pusher:[]	paid:[]	vax:[]	
#JailF	f:[]	jail:[]	
#WeStandWithItaly	with:[]	stand:[]	italy:[]	we:[]	
#TransportDay	transport:[]	day:[]	
#VaccineInjuryRealNotRare	not:[]	vaccine:[]	rare:[]	real:[]	injury:[]	
#CanYouSeeItNow	can:[]	see:[]	now:[]	it:[]	you:[]	
#StopGettingTested	getting:[]	stop:[]	tested:[]	
#ProudNeverSleever	never:[]	proud:[]	sleever:[]	
#GetVac	get:[]	vac:[]	
#MasksOff	masks:[]	off:[]	
#HoldtheLine	holdthe:[]	line:[]	
#PlanB	b:[]	plan:[]	
#PlanA	a:[]	plan:[]	
#KyrieIrving	kyrie:[]	irving:[]	
#FakeMayors	mayors:[]	fake:[]	
#BillsMafia	mafia:[]	bills:[]	
#CoronaVaccines	vaccines:[]	corona:[]	
#NoMedicalTyran	tyran:[]	no:[]	medical:[]	
#RestInPeace	rest:[]	in:[]	peace:[]	
#PassSanitair	pass:[]	sanitair:[]	
#AlexJones	alex:[]	jones:[]	
#BillGatesIsEvil	gates:[]	bill:[]	is:[]	evil:[]	
#GetVax	get:[]	vax:[]	
#StopGovernmentOverreach	government:[]	stop:[]	overreach:[]	
#TrudeauworstPMever	p:[]	trudeauworst:[]	mever:[]	
#GetVaxxed	vaxxed:[]	get:[]	
#NoCovidPassports	no:[]	covid:[]	passports:[]	
#NightTimeEconomy	night:[]	economy:[]	time:[]	
#FauciLieAndPeopleDie	die:[]	and:[]	lie:[]	fauci:[]	people:[]	
#HousePfizer	pfizer:[]	house:[]	
#NonAuPassSanitaire	au:[]	pass:[]	sanitaire:[]	non:[]	
#wewillALLbether	lbether:[]	a:[]	wewill:[]	l:[]	
#MeeeeToooo	toooo:[]	meeee:[]	
#BinTheMask	the:[]	bin:[]	mask:[]	
#JesusChrist	christ:[]	jesus:[]	
#ArrestPaulReid	arrest:[]	reid:[]	paul:[]	
#VaccineSafetyEnquiryNow	vaccine:[]	safety:[]	now:[]	enquiry:[]	
#QRCode	q:[]	r:[]	code:[]	
#SmokingGun	gun:[]	smoking:[]	
#OpenFor	for:[]	open:[]	
#WhereIsDougFord	doug:[]	is:[]	where:[]	ford:[]	
#ItIsAScam	a:[]	scam:[]	is:[]	it:[]	
#COVIDJab	c:[]	d:[]	v:[]	i:[]	jab:[]	o:[]	
#TheGreatReject	the:[]	reject:[]	great:[]	
#NoVaccine	no:[]	vaccine:[]	
#PurpleWave	purple:[]	wave:[]	
#FauciLie	lie:[]	fauci:[]	
#SayNoToVacci	no:[]	vacci:[]	say:[]	to:[]	
#PfizerWhistleblower	whistleblower:[]	pfizer:[]	
#WeToldYouSo	told:[]	so:[]	you:[]	we:[]	
#GatesOfHell	gates:[]	of:[]	hell:[]	
#WontBackDown	back:[]	wont:[]	down:[]	
#NonAuPassSanitai	sanitai:[]	au:[]	pass:[]	non:[]	
#NoVaccinePassportsAn	no:[]	vaccine:[]	passports:[]	an:[]	
#NoCovidID	no:[]	covid:[]	d:[]	i:[]	
#NoVaccinePassportsAnyw	no:[]	vaccine:[]	anyw:[]	passports:[]	
#WeatherWeapons	weather:[]	weapons:[]	
#NuremberCode	code:[]	nurember:[]	
#FreeToTravel	to:[]	travel:[]	free:[]	
#WakeTheFuckUp	the:[]	wake:[]	fuck:[]	up:[]	
#FreshVoicesRi	ri:[]	voices:[]	fresh:[]	
#WeThePeopleMust	the:[]	must:[]	people:[]	we:[]	
#GetBoosted	get:[]	boosted:[]	
#BidensAmerica	bidens:[]	america:[]	
#PassDeLaHonte	de:[]	honte:[]	la:[]	pass:[]	
#HealthcareFreedom	freedom:[]	healthcare:[]	
#COPGlasgow	p:[]	glasgow:[]	c:[]	o:[]	
#BloodOnHisHands	hands:[]	his:[]	blood:[]	on:[]	
#RemoveRon	ron:[]	remove:[]	
#WuhanFlu	wuhan:[]	flu:[]	
#ResinstateSimonWard	simon:[]	resinstate:[]	ward:[]	
#WestJet	jet:[]	west:[]	
#FireKieranMoore	moore:[]	kieran:[]	fire:[]	
#UnderTheInfluence	the:[]	under:[]	influence:[]	
#fireFauci	fire:[]	fauci:[]	
#VaccineCertificate	vaccine:[]	certificate:[]	
#FakePandemic	fake:[]	pandemic:[]	
#COVIDCanada	c:[]	canada:[]	d:[]	v:[]	i:[]	o:[]	
#PfizerLeaks	leaks:[]	pfizer:[]	
#GetTheShot	the:[]	get:[]	shot:[]	
#SackDanAndrews	dan:[]	sack:[]	andrews:[]	
#EndMedicalTyranny	medical:[]	tyranny:[]	end:[]	
#NaziWorldOrder	nazi:[]	world:[]	order:[]	
#GrowAPair	a:[]	grow:[]	pair:[]	
#NoToCovidChil	no:[]	covid:[]	chil:[]	to:[]	
#ShameOnAussies	shame:[]	aussies:[]	on:[]	
#ComedyGold	gold:[]	comedy:[]	
#DoNoHarm	no:[]	harm:[]	do:[]	
#ToryCriminals	tory:[]	criminals:[]	
#JudgementDay	judgement:[]	day:[]	
#CourageIsContagious	contagious:[]	is:[]	courage:[]	
#AusOpen	open:[]	aus:[]	
#DesperateDan	dan:[]	desperate:[]	
#VaccinesWor	vaccines:[]	wor:[]	
#PLANdemic	p:[]	a:[]	l:[]	ndemic:[]	
#ScotlandNeedsToStandUp	needs:[]	up:[]	to:[]	stand:[]	scotland:[]	
#DoNo	no:[]	do:[]	
#NoMandates	no:[]	mandates:[]	
#MetaStupid	stupid:[]	meta:[]	
#VaccineSideEffe	side:[]	vaccine:[]	effe:[]	
#aboriginalsRejectVAX	a:[]	aboriginals:[]	v:[]	reject:[]	x:[]	
#NoMandatee	no:[]	mandatee:[]	
#FcukNaziUrsulaVonderLeyen	nazi:[]	vonder:[]	ursula:[]	leyen:[]	fcuk:[]	
#NonAuP	p:[]	au:[]	non:[]	
#FoxNews	news:[]	fox:[]	
#WakeUpAmerica	wake:[]	up:[]	america:[]	
#IStandWithFloyd	with:[]	floyd:[]	i:[]	stand:[]	
#OpenFora	fora:[]	open:[]	
#GlobalRest	rest:[]	global:[]	
#FuckOffPlanB	b:[]	fuck:[]	plan:[]	off:[]	
#NoEuro	no:[]	euro:[]	
#SteveDeace	deace:[]	steve:[]	
#ItIsOver	over:[]	is:[]	it:[]	
#TelAviv	tel:[]	aviv:[]	
#ReinstateJoel	reinstate:[]	joel:[]	
#PharmaFascism	pharma:[]	fascism:[]	
#ChooseLife	choose:[]	life:[]	
#HoldTheLineAustria	the:[]	line:[]	austria:[]	hold:[]	
#AstroWorld	world:[]	astro:[]	
#SaturdayThoughts	thoughts:[]	saturday:[]	
#GreatReset	reset:[]	great:[]	
#PandemicOfTheVaccina	the:[]	vaccina:[]	of:[]	pandemic:[]	
#SaveNY	save:[]	y:[]	n:[]	
#NoVaccineNoPandemic	no:[]	vaccine:[]	pandemic:[]	
#ThankYouDrFauci	thank:[]	fauci:[]	dr:[]	you:[]	
#SuddenDeath	death:[]	sudden:[]	
#AShallNOTBeInfringed	a:[]	infringed:[]	be:[]	t:[]	shall:[]	n:[]	o:[]	
#NoVaccineCoercion	no:[]	vaccine:[]	coercion:[]	
#NOGreenPass	green:[]	pass:[]	n:[]	o:[]	
#MayoClinic	mayo:[]	clinic:[]	
#SayNoToTyranny	no:[]	tyranny:[]	say:[]	to:[]	
#CBSENews	news:[]	b:[]	s:[]	c:[]	e:[]	
#RickNicholls	nicholls:[]	rick:[]	
#RtePai	rte:[]	pai:[]	
#DunningKruger	kruger:[]	dunning:[]	
#MaskUp	up:[]	mask:[]	
#FFauci	f:[]	fauci:[]	
#HumanRight	right:[]	human:[]	
#FreedomFlu	freedom:[]	flu:[]	
#NoVaccinePassport	no:[]	vaccine:[]	passport:[]	
#StrongerTogeth	togeth:[]	stronger:[]	
#IChooseFreedom	freedom:[]	i:[]	choose:[]	
#DNAHarvesting	a:[]	harvesting:[]	d:[]	n:[]	
#COVIDdenying	c:[]	ddenying:[]	v:[]	i:[]	o:[]	
#NoGreatReset	no:[]	reset:[]	great:[]	
#VaxUp	up:[]	vax:[]	
#NeverForget	never:[]	forget:[]	
#EnoughI	i:[]	enough:[]	
#arrestBroula	arrest:[]	broula:[]	
#NoCensorship	no:[]	censorship:[]	
#MandatesAreNotLaws	not:[]	laws:[]	are:[]	mandates:[]	
#NoForcedvaccination	no:[]	forcedvaccination:[]	
#LoveWins	wins:[]	love:[]	
#NoGreenPassday	passday:[]	no:[]	green:[]	
#ThirdDoses	doses:[]	third:[]	
#GenocideGames	games:[]	genocide:[]	
#AbortionRights	abortion:[]	rights:[]	
#RightInOurFaces	in:[]	right:[]	faces:[]	our:[]	
#CovidWarriors	covid:[]	warriors:[]	
#FreedomOf	freedom:[]	of:[]	
#notNormal	normal:[]	not:[]	
#ClimateChangeHoax	change:[]	climate:[]	hoax:[]	
#PoliceAccountability	police:[]	accountability:[]	
#WakeUpHumanity	wake:[]	up:[]	humanity:[]	
#NoamChomsky	chomsky:[]	noam:[]	
#IStandWithCinemaAndCo	with:[]	and:[]	i:[]	cinema:[]	co:[]	stand:[]	
#UnlawfulManda	unlawful:[]	manda:[]	
#BringBackNor	nor:[]	bring:[]	back:[]	
#LockdownsKill	lockdowns:[]	kill:[]	
#FauciDogTorturer	torturer:[]	fauci:[]	dog:[]	
#KillerVAX	a:[]	v:[]	x:[]	killer:[]	
#AntiZionism	zionism:[]	anti:[]	
#VoteACDP	p:[]	a:[]	c:[]	d:[]	vote:[]	
#TedCruz	ted:[]	cruz:[]	
#GreatRes	res:[]	great:[]	
#OneOfTheMillion	the:[]	million:[]	of:[]	one:[]	
#AltoAdige	adige:[]	alto:[]	
#CostaRica	rica:[]	costa:[]	
#TerryBradshaw	bradshaw:[]	terry:[]	
#GiveNoQuarter	no:[]	give:[]	quarter:[]	
#ndAmendment	amendment:[]	nd:[]	
#ResistNFightBack	resist:[]	back:[]	fight:[]	n:[]	
#NoMan	no:[]	man:[]	
#NonALaVaccinationObligatoire	a:[]	la:[]	obligatoire:[]	non:[]	vaccination:[]	
#FreedomNow	freedom:[]	now:[]	
#CovidChargeCode	covid:[]	code:[]	charge:[]	
#GreenpassObbli	obbli:[]	greenpass:[]	
#MKUltraDARPA	p:[]	a:[]	r:[]	d:[]	k:[]	m:[]	ultra:[]	
#DrBridle	bridle:[]	dr:[]	
#AustriaHasF	f:[]	has:[]	austria:[]	
#NewZealand	new:[]	zealand:[]	
#GetTheVax	the:[]	get:[]	vax:[]	
#DEAliedMonkeysDied	monkeys:[]	alied:[]	d:[]	e:[]	died:[]	
#TorySewag	tory:[]	sewag:[]	
#MyShot	my:[]	shot:[]	
#covidScam	covid:[]	scam:[]	
#WeWillAl	will:[]	al:[]	we:[]	
#ProjectVeritas	veritas:[]	project:[]	
#OneLove	love:[]	one:[]	
#NoVaxForKids	no:[]	for:[]	vax:[]	kids:[]	
#NotAconspiracy	not:[]	aconspiracy:[]	
#TeamUSA	a:[]	s:[]	u:[]	team:[]	
#WeAreNotLabRats	not:[]	are:[]	rats:[]	lab:[]	we:[]	
#StopFiringPeople	stop:[]	firing:[]	people:[]	
#WeWillA	a:[]	will:[]	we:[]	
#RealDeal	deal:[]	real:[]	
#VaxIllusion	vax:[]	illusion:[]	
#NoJabMe	no:[]	me:[]	jab:[]	
#DepopulationPlan	depopulation:[]	plan:[]	
#EyesWideShut	shut:[]	wide:[]	eyes:[]	
#IStandWithFreedomFighters	with:[]	freedom:[]	i:[]	stand:[]	fighters:[]	
#StopTheCovidFearHoax	the:[]	covid:[]	stop:[]	hoax:[]	fear:[]	
#EndSc	sc:[]	end:[]	
#VaccineMessaging	vaccine:[]	messaging:[]	
#GlobalElite	elite:[]	global:[]	
#FreedomNotForce	not:[]	freedom:[]	force:[]	
#VaccineApartheid	vaccine:[]	apartheid:[]	
#FreedonOfChoice	freedon:[]	of:[]	choice:[]	
#CountingOurDead	counting:[]	dead:[]	our:[]	
#NOTRosaParks	parks:[]	t:[]	rosa:[]	n:[]	o:[]	
#TurdReich	turd:[]	reich:[]	
#CathayWagantall	cathay:[]	wagantall:[]	
#ProtectYourCommunity	your:[]	protect:[]	community:[]	
#reutersUK	reuters:[]	u:[]	k:[]	
#ProudBoys	proud:[]	boys:[]	
#WorldAIDSDay	a:[]	s:[]	world:[]	d:[]	i:[]	day:[]	
#GeneSimmons	simmons:[]	gene:[]	
#TogetherDeclaration	declaration:[]	together:[]	
#BillGatesKillerVax	gates:[]	bill:[]	killer:[]	vax:[]	
#TOpoli	t:[]	opoli:[]	
#NaziPass	nazi:[]	pass:[]	
#BidenHarrisRegimeMustGo	biden:[]	regime:[]	harris:[]	go:[]	must:[]	
#SmashtheWEF	e:[]	f:[]	w:[]	smashthe:[]	
#NoMed	no:[]	med:[]	
#OVHealthcare	v:[]	healthcare:[]	o:[]	
#BeLikeBernie	be:[]	bernie:[]	like:[]	
#MarketingStrategy	marketing:[]	strategy:[]	
#ConspiracyTheorists	conspiracy:[]	theorists:[]	
#LeaveUsAlone	alone:[]	leave:[]	us:[]	
#VotingRightsAct	act:[]	rights:[]	voting:[]	
#BetoORourke	beto:[]	rourke:[]	o:[]	
#ClimateScam	scam:[]	climate:[]	
#WEF#NWO	e:[]	f:[]	w:[]	n:[]	o:[]	
#VaccineCentury	century:[]	vaccine:[]	
#NoForcedVax	no:[]	forced:[]	vax:[]	
#CovidFearPorn	covid:[]	porn:[]	fear:[]	
#noDiscrimination	no:[]	discrimination:[]	
#SNPGreen	p:[]	green:[]	s:[]	n:[]	
#TheGreatReset	the:[]	reset:[]	great:[]	
#QRankzinnigheid	q:[]	rankzinnigheid:[]	
#RiseOurLives	lives:[]	rise:[]	our:[]	
#HeilNWO	heil:[]	w:[]	n:[]	o:[]	
#StudentsProtest	students:[]	protest:[]	
#EQRCode	q:[]	r:[]	code:[]	e:[]	
#FailedGovernment	government:[]	failed:[]	
#HippocraticOath	oath:[]	hippocratic:[]	
#NaziCovidVax	nazi:[]	covid:[]	vax:[]	
#SaveBulgaria	bulgaria:[]	save:[]	
#DoNorComply	nor:[]	comply:[]	do:[]	
#LateLateShow	late:[]	show:[]	
#TruthSeekers	truth:[]	seekers:[]	
#SoWhat	what:[]	so:[]	
#SkyNews	news:[]	sky:[]	
#ReallyBigShow	big:[]	show:[]	really:[]	
#HoCoMD	d:[]	ho:[]	co:[]	m:[]	
#TheKidsAreOk	the:[]	are:[]	ok:[]	kids:[]	
#GoWOKEgetBROKE	r:[]	b:[]	e:[]	w:[]	go:[]	k:[]	eget:[]	o:[]	
#vaccineSide	side:[]	vaccine:[]	
#TruthAboutTembisa	truth:[]	about:[]	tembisa:[]	
#CovidLies	covid:[]	lies:[]	
#ResignBide	bide:[]	resign:[]	
#AntiVaxxers	vaxxers:[]	anti:[]	
#QRWeigeraar	q:[]	r:[]	weigeraar:[]	
#GovernmentTyranny	government:[]	tyranny:[]	
#SARSCoV	a:[]	r:[]	s:[]	v:[]	co:[]	
#StopTheTrialVaccinesNow	the:[]	stop:[]	vaccines:[]	now:[]	trial:[]	
#MSMLies	s:[]	lies:[]	m:[]	
#CovidVax	covid:[]	vax:[]	
#GetVaxed	vaxed:[]	get:[]	
#HouseOfCards	cards:[]	of:[]	house:[]	
#IWillStandWithYou	with:[]	will:[]	i:[]	stand:[]	you:[]	
#BidenAdministration	biden:[]	administration:[]	
#OperationLockstep	lockstep:[]	operation:[]	
#FauciTheFraud	the:[]	fraud:[]	fauci:[]	
#EricAdams	adams:[]	eric:[]	
#CultOfTheMisinformed	the:[]	cult:[]	of:[]	misinformed:[]	
#FolloForFolloBack	follo:[]	for:[]	back:[]	
#CovidVic	vic:[]	covid:[]	
#GetVaccinated#GetVac	get:[]	vac:[]	vaccinated:[]	
#ClimateHypocrite	climate:[]	hypocrite:[]	
#OmicronVirus	omicron:[]	virus:[]	
#FreeSpeech	speech:[]	free:[]	
#VaccinePassport	vaccine:[]	passport:[]	
#ClimateHypocrisy	hypocrisy:[]	climate:[]	
#BoycottCovidPassBars	covid:[]	pass:[]	boycott:[]	bars:[]	
#SaveChildren	children:[]	save:[]	
#JohnsonIsSp	is:[]	johnson:[]	sp:[]	
#VaccinesW	vaccines:[]	w:[]	
#SpeakUpMen	men:[]	speak:[]	up:[]	
#IWill	will:[]	i:[]	
#NoVaccinePassportAnywher	no:[]	vaccine:[]	passport:[]	anywher:[]	
#WearADamnMask	damn:[]	a:[]	wear:[]	mask:[]	
#HamOnt	ont:[]	ham:[]	
#WorldWideFreedomRall	world:[]	freedom:[]	wide:[]	rall:[]	
#NoVaccineASU	a:[]	no:[]	vaccine:[]	s:[]	u:[]	
#PatientAdvocacy	patient:[]	advocacy:[]	
#PaidMedia	paid:[]	media:[]	
#EricClapton	clapton:[]	eric:[]	
#BidenDisaster	biden:[]	disaster:[]	
#CannabisCommunity	cannabis:[]	community:[]	
#VaccineSideEff	side:[]	vaccine:[]	eff:[]	
#NoJabForMe	no:[]	me:[]	for:[]	jab:[]	
#ProCho	cho:[]	pro:[]	
#VaxLiars	liars:[]	vax:[]	
#NoVaxPassports	no:[]	passports:[]	vax:[]	
#CarryOn	carry:[]	on:[]	
#StopObeying	stop:[]	obeying:[]	
#HandsOffOurChildre	hands:[]	childre:[]	our:[]	off:[]	
#WeWillAllBeThere	all:[]	be:[]	will:[]	there:[]	we:[]	
#saynotoNWO	w:[]	saynoto:[]	n:[]	o:[]	
#BigPharmaGreed	big:[]	greed:[]	pharma:[]	
#JacindaOut	jacinda:[]	out:[]	
#TheDrugsDontWork	the:[]	drugs:[]	work:[]	dont:[]	
#BarsArduc	arduc:[]	bars:[]	
#PCRTest	p:[]	r:[]	c:[]	test:[]	
#JacindaArdern	jacinda:[]	ardern:[]	
#GetArmed	armed:[]	get:[]	
#VaccineIsPoison	vaccine:[]	poison:[]	is:[]	
#HoldTheLine	the:[]	line:[]	hold:[]	
#GOPDeathCult	p:[]	cult:[]	death:[]	g:[]	o:[]	
#TheirABC	a:[]	b:[]	c:[]	their:[]	
#KrummerSchwanzlutscher	schwanzlutscher:[]	krummer:[]	
#ClimateChangeDeniers	change:[]	climate:[]	deniers:[]	
#CubaLibre	libre:[]	cuba:[]	
#BoycottSesa	sesa:[]	boycott:[]	
#BigBrotherJohnson	big:[]	johnson:[]	brother:[]	
#TennesseeCOVID	c:[]	d:[]	tennessee:[]	v:[]	i:[]	o:[]	
#NoClimateEmergency	no:[]	emergency:[]	climate:[]	
#NoVac	no:[]	vac:[]	
#IdoNOTconsent	ido:[]	tconsent:[]	n:[]	o:[]	
#GoVaxx	go:[]	vaxx:[]	
#CovidMURDERERS	r:[]	covid:[]	s:[]	d:[]	e:[]	u:[]	m:[]	
#LiveFree	free:[]	live:[]	
#NoMor	mor:[]	no:[]	
#WeWi	wi:[]	we:[]	
#NoMedicalApart	no:[]	medical:[]	apart:[]	
#FauciLeaks	leaks:[]	fauci:[]	
#HumanRightsViolations	violations:[]	rights:[]	human:[]	
#NeverV	never:[]	v:[]	
#DemandEvidence	evidence:[]	demand:[]	
#NotMyAustralia	not:[]	australia:[]	my:[]	
#VaccineCoverups	vaccine:[]	coverups:[]	
#JoeBidensAmerica	joe:[]	bidens:[]	america:[]	
#BuildBackBadder	build:[]	back:[]	badder:[]	
#MakeOrwellFictionAgain	fiction:[]	again:[]	orwell:[]	make:[]	
#SaveTheChildrenPlease	the:[]	children:[]	save:[]	please:[]	
#StopVaxingKids	stop:[]	kids:[]	vaxing:[]	
#ChuckTodd	chuck:[]	todd:[]	
#LambdaVariant	lambda:[]	variant:[]	
#CovidCrimesAgainstHumanity	covid:[]	against:[]	crimes:[]	humanity:[]	
#NoVaccinePassportsANYWHERE	a:[]	no:[]	r:[]	vaccine:[]	e:[]	w:[]	h:[]	y:[]	passports:[]	n:[]	
#LockHimUp	lock:[]	up:[]	him:[]	
#MSMLiars	s:[]	liars:[]	m:[]	
#CoronaVirusCanada	canada:[]	virus:[]	corona:[]	
#YoNoMeVacuno	no:[]	yo:[]	me:[]	vacuno:[]	
#ClimateScience	science:[]	climate:[]	
#IUtah	utah:[]	i:[]	
#JeremyVine	jeremy:[]	vine:[]	
#WillNotComplyEVER	r:[]	not:[]	comply:[]	e:[]	will:[]	v:[]	
#EqualTesting	equal:[]	testing:[]	
#NoVaccinePassort	no:[]	vaccine:[]	passort:[]	
#BuildBackBetter	better:[]	build:[]	back:[]	
#GetVaccinated#FullyVaccinated#COVIDIOTS	s:[]	c:[]	t:[]	d:[]	v:[]	get:[]	i:[]	vaccinated:[]	fully:[]	o:[]	
#PlagueSpreadersCaucus	spreaders:[]	caucus:[]	plague:[]	
#SaysItAll	all:[]	it:[]	says:[]	
#COVIDScam	c:[]	d:[]	v:[]	scam:[]	i:[]	o:[]	
#EUNazis	u:[]	e:[]	nazis:[]	
#BanCovidVaxNow	covid:[]	now:[]	vax:[]	ban:[]	
#TheMediaIsTheVirus	the:[]	is:[]	media:[]	virus:[]	
#LosAngeles	los:[]	angeles:[]	
#NoGreenPassObligatorio	no:[]	green:[]	pass:[]	obligatorio:[]	
#GeenG	g:[]	geen:[]	
#CovidAppBoycott	app:[]	covid:[]	boycott:[]	
#NoVax	no:[]	vax:[]	
#RidiculousBehaviour	ridiculous:[]	behaviour:[]	
#BuenosAires	aires:[]	buenos:[]	
#DoNotComply	not:[]	comply:[]	do:[]	
#DoFo	fo:[]	do:[]	
#SundayThoughts	thoughts:[]	sunday:[]	
#EnoughIsE	e:[]	is:[]	enough:[]	
#PublicTransport	public:[]	transport:[]	
#LeaveNoDoubt	no:[]	leave:[]	doubt:[]	
#ResignYousaf	yousaf:[]	resign:[]	
#TrudeauM	trudeau:[]	m:[]	
#BlackTwitterMovement	twitter:[]	black:[]	movement:[]	
#MeidasMighty	meidas:[]	mighty:[]	
#NationalClottery	national:[]	clottery:[]	
#FreshV	v:[]	fresh:[]	
#CrimesAgainsHumanity	crimes:[]	agains:[]	humanity:[]	
#OpDomesticTerr	domestic:[]	op:[]	terr:[]	
#SuddenCollap	collap:[]	sudden:[]	
#TerribleTuesday	tuesday:[]	terrible:[]	
#MaskMandate	mandate:[]	mask:[]	
#GlobalistSlave	slave:[]	globalist:[]	
#GlobalProtest	global:[]	protest:[]	
#StandWithNurseKat	with:[]	nurse:[]	stand:[]	kat:[]	
#RiseUpAustralia	australia:[]	up:[]	rise:[]	
#IStandWithCareWorkers	with:[]	i:[]	stand:[]	workers:[]	care:[]	
#NoForcedInjections	injections:[]	no:[]	forced:[]	
#LungClots	clots:[]	lung:[]	
#COVIDVa	c:[]	d:[]	v:[]	i:[]	va:[]	o:[]	
#OToole	toole:[]	o:[]	
#TheNewNormal	the:[]	normal:[]	new:[]	
#BidenIsAFailure	biden:[]	a:[]	failure:[]	is:[]	
#GetFullyVaxxed	vaxxed:[]	get:[]	fully:[]	
#VaincreLeCovi	covi:[]	vaincre:[]	le:[]	
#VaccineTaboo	vaccine:[]	taboo:[]	
#CapitalismKills	kills:[]	capitalism:[]	
#SuzieSub	sub:[]	suzie:[]	
#StayInformed	informed:[]	stay:[]	
#NoGreenPa	pa:[]	no:[]	green:[]	
#CheckIns	check:[]	ins:[]	
#NoNWO	no:[]	w:[]	n:[]	o:[]	
#novaccinePassports	novaccine:[]	passports:[]	
#WearAMa	a:[]	ma:[]	wear:[]	
#TellTheTruth	the:[]	truth:[]	tell:[]	
#TruthWins	wins:[]	truth:[]	
#WuhanFl	wuhan:[]	fl:[]	
#DataAnalytics	analytics:[]	data:[]	
#OncTwitter	twitter:[]	onc:[]	
#CovidVaccineRace	vaccine:[]	covid:[]	race:[]	
#HumanMorbidityFatility	fatility:[]	morbidity:[]	human:[]	
#FirstDoNoHarm	no:[]	harm:[]	do:[]	first:[]	
#NoMoreApologies	no:[]	more:[]	apologies:[]	
#WearAMaskSaveALife	a:[]	save:[]	wear:[]	life:[]	mask:[]	
#FordFailedThePeople	the:[]	failed:[]	ford:[]	people:[]	
#GetRidOfBoris	boris:[]	of:[]	get:[]	rid:[]	
#CentralCoast	coast:[]	central:[]	
#ToryCorruption	tory:[]	corruption:[]	
#TrueBlood	true:[]	blood:[]	
#WeThePeople	the:[]	people:[]	we:[]	
#SerbianRevolution	revolution:[]	serbian:[]	
#CovidCon	covid:[]	con:[]	
#CapeTown	town:[]	cape:[]	
#TheGre	the:[]	gre:[]	
#BigW	big:[]	w:[]	
#GetVaccinat	get:[]	vaccinat:[]	
#ServeAndProtect	and:[]	protect:[]	serve:[]	
#EUCovidCertificate	covid:[]	u:[]	e:[]	certificate:[]	
#OpenForSummer	for:[]	summer:[]	open:[]	
#crimesAgainstHumanity	against:[]	crimes:[]	humanity:[]	
#HumanRightsViolated	violated:[]	rights:[]	human:[]	
#MoronicVariant	moronic:[]	variant:[]	
#FreshAir	air:[]	fresh:[]	
#PublicHealthScotland	public:[]	health:[]	scotland:[]	
#MediaIsTheVirus	the:[]	is:[]	media:[]	virus:[]	
#DougFords	doug:[]	fords:[]	
#StayAwayFromMyChildren	away:[]	children:[]	from:[]	my:[]	stay:[]	
#SayNoToMandate	no:[]	mandate:[]	say:[]	to:[]	
#TheNationals	the:[]	nationals:[]	
#CovidToe	covid:[]	toe:[]	
#ClimateEmerge	emerge:[]	climate:[]	
#AustriaHasFallen	fallen:[]	has:[]	austria:[]	
#ObamaSoFine	fine:[]	obama:[]	so:[]	
#ROEvWADE	a:[]	ev:[]	r:[]	d:[]	e:[]	w:[]	o:[]	
#WeStandWithIsrael	with:[]	israel:[]	stand:[]	we:[]	
#VaccineMandates	vaccine:[]	mandates:[]	
#FakeSocialist	socialist:[]	fake:[]	
#TogetherDec	dec:[]	together:[]	
#LetDoctorsBeDoctors	be:[]	doctors:[]	let:[]	
#SciComm	comm:[]	sci:[]	
#EndTheStateOfEmergency	the:[]	of:[]	emergency:[]	end:[]	state:[]	
#AntiMandate	mandate:[]	anti:[]	
#BBCNews	news:[]	b:[]	c:[]	
#FreedomOfChoice	freedom:[]	of:[]	choice:[]	
#FFrauci	frauci:[]	f:[]	
#IHaveAVoice	voice:[]	a:[]	have:[]	i:[]	
#BigPharmaCa	big:[]	pharma:[]	ca:[]	
#LdnOnt	ont:[]	ldn:[]	
#WoWs	wo:[]	ws:[]	
#BillGatesBioTerrorist	gates:[]	bio:[]	bill:[]	terrorist:[]	
#ArrestWhitty	arrest:[]	whitty:[]	
#TheyWalkAmongUs	among:[]	us:[]	walk:[]	they:[]	
#MyBodyMyChoice	choice:[]	body:[]	my:[]	
#COVIDa	c:[]	v:[]	i:[]	da:[]	o:[]	
#NoVme	no:[]	vme:[]	
#WhiteJesusCult	jesus:[]	cult:[]	white:[]	
#VaccineHesitants	hesitants:[]	vaccine:[]	
#TruthShallPrevail	truth:[]	prevail:[]	shall:[]	
#NorthKorea	korea:[]	north:[]	
#NoMandatoryJabs	no:[]	jabs:[]	mandatory:[]	
#CreatedEmergencies	emergencies:[]	created:[]	
#FuckJoeandtheKamelToeHo	ho:[]	fuck:[]	toe:[]	joeandthe:[]	kamel:[]	
#PsyOp	op:[]	psy:[]	
#FreedomFighters	freedom:[]	fighters:[]	
#FuckBlockchain	blockchain:[]	fuck:[]	
#meinFauci	fauci:[]	mein:[]	
#BranchCovidian	covidian:[]	branch:[]	
#FcukOffCoveney	coveney:[]	fcuk:[]	off:[]	
#VaxxItOrCasket	or:[]	casket:[]	it:[]	vaxx:[]	
#TogetherDeclar	declar:[]	together:[]	
#SaveOurKids	save:[]	our:[]	kids:[]	
#WeSeeTheirPlan	see:[]	their:[]	plan:[]	we:[]	
#VivaItalia	italia:[]	viva:[]	
#NoApartheid	no:[]	apartheid:[]	
#AbortionBan	abortion:[]	ban:[]	
#ForcedVaccination	forced:[]	vaccination:[]	
#QueenJames	queen:[]	james:[]	
#ClimateTAXES	a:[]	s:[]	t:[]	e:[]	x:[]	climate:[]	
#ResistCovid	covid:[]	resist:[]	
#AvGeek	geek:[]	av:[]	
#NewsBreak	news:[]	break:[]	
#BloodClots	clots:[]	blood:[]	
#ProfitsOverPeople	over:[]	profits:[]	people:[]	
#LoneStarState	star:[]	lone:[]	state:[]	
#JesusisComing	jesusis:[]	coming:[]	
#DontTouchMyChildren	children:[]	touch:[]	my:[]	dont:[]	
#ResistTheLeakyJab	the:[]	leaky:[]	resist:[]	jab:[]	
#AdverseReactions	reactions:[]	adverse:[]	
#GlobalDictatorship	global:[]	dictatorship:[]	
#SaveTheKidsFromCovidVax	the:[]	covid:[]	save:[]	from:[]	vax:[]	kids:[]	
#NeverForgetJanuaryth	never:[]	forget:[]	januaryth:[]	
#HealthcareIsAHumanRight	a:[]	is:[]	right:[]	human:[]	healthcare:[]	
#arrestGatez	arrest:[]	gatez:[]	
#NoJabsKids	no:[]	jabs:[]	kids:[]	
#NoBraDay	bra:[]	no:[]	day:[]	
#PureBlood	pure:[]	blood:[]	
#NoGrea	no:[]	grea:[]	
#AbsoluteMashedPotatoes	potatoes:[]	mashed:[]	absolute:[]	
#NoGree	no:[]	gree:[]	
#FundamentalRights	rights:[]	fundamental:[]	
#RogerStone	roger:[]	stone:[]	
#NoVaccin	vaccin:[]	no:[]	
#ControlByTheMedia	the:[]	by:[]	control:[]	media:[]	
#HoldThemAccountable	accountable:[]	them:[]	hold:[]	
#BSCGem	b:[]	c:[]	s:[]	gem:[]	
#TimesSquare	square:[]	times:[]	
#BorisTheLiar	the:[]	boris:[]	liar:[]	
#WorldWarIII	world:[]	i:[]	war:[]	
#NoMandatoryVaccine	no:[]	vaccine:[]	mandatory:[]	
#CampForFreedom	freedom:[]	for:[]	camp:[]	
#TrumpCult	trump:[]	cult:[]	
#MondayMotiv	motiv:[]	monday:[]	
#HandsOffOurKids	hands:[]	our:[]	off:[]	kids:[]	
#CdnSci	sci:[]	cdn:[]	
#WorldWideRallyForFreedom	world:[]	freedom:[]	wide:[]	for:[]	rally:[]	
#NoBooster	no:[]	booster:[]	
#HoldTh	th:[]	hold:[]	
#WesupportNoel	wesupport:[]	noel:[]	
#PsakiBomb	bomb:[]	psaki:[]	
#WeedOutBadDoctors	bad:[]	doctors:[]	weed:[]	out:[]	
#InformedCo	informed:[]	co:[]	
#AaronRogers	aaron:[]	rogers:[]	
#DoNotC	not:[]	c:[]	do:[]	
#NoForcedVaccine	no:[]	vaccine:[]	forced:[]	
#BackTheBlue	the:[]	blue:[]	back:[]	
#VaccinateYourChildren	vaccinate:[]	children:[]	your:[]	
#NoVaccinePas	no:[]	vaccine:[]	pas:[]	
#MelbourneCityCouncil	city:[]	council:[]	melbourne:[]	
#NoCompulsoryVaccines	no:[]	compulsory:[]	vaccines:[]	
#IamMillion	million:[]	iam:[]	
#LetsGoBozo	go:[]	lets:[]	bozo:[]	
#SoldierOfGods	soldier:[]	gods:[]	of:[]	
#DPOPShot	p:[]	d:[]	shot:[]	o:[]	
#StopVaccineCoercion	vaccine:[]	stop:[]	coercion:[]	
#SundayMoti	sunday:[]	moti:[]	
#VaccinePas	vaccine:[]	pas:[]	
#CommUNITYimmUNITY	comm:[]	t:[]	u:[]	yimm:[]	y:[]	i:[]	n:[]	
#SouthSac	sac:[]	south:[]	
#DallasTX	dallas:[]	t:[]	x:[]	
#NameandShame	shame:[]	nameand:[]	
#TakeBackOurPower	take:[]	back:[]	power:[]	our:[]	
#NoVaccinepassportsAnywhere	no:[]	vaccinepassports:[]	anywhere:[]	
#AustralianRevolutioNow	now:[]	revolutio:[]	australian:[]	
#UnityOverDivision	division:[]	over:[]	unity:[]	
#ShT	t:[]	sh:[]	
#HoldTheLine#DoNotComply	the:[]	not:[]	comply:[]	line:[]	do:[]	hold:[]	
#MyTwitterAnniversary	twitter:[]	my:[]	anniversary:[]	
#ScottGreen	green:[]	scott:[]	
#teamUnvaccinated	unvaccinated:[]	team:[]	
#LyndonClark	clark:[]	lyndon:[]	
#BitcoinSV	s:[]	v:[]	bitcoin:[]	
#NeverVoteConservative	never:[]	conservative:[]	vote:[]	
#HoldYourLine	line:[]	your:[]	hold:[]	
#WorldWideFreedomRally	world:[]	freedom:[]	wide:[]	rally:[]	
#InfowarsArmy	army:[]	infowars:[]	
#WeAreAllInThisTogether	all:[]	in:[]	are:[]	this:[]	together:[]	we:[]	
#GetVacc	get:[]	vacc:[]	
#wtpEARTH	a:[]	r:[]	wtp:[]	t:[]	e:[]	h:[]	
#NotAVaccine	a:[]	vaccine:[]	not:[]	
#ASTROWORLDFest	a:[]	r:[]	s:[]	d:[]	t:[]	w:[]	l:[]	fest:[]	o:[]	
#greenpaSS	s:[]	greenpa:[]	
#AllStates	all:[]	states:[]	
#DountoOthers	dounto:[]	others:[]	
#DontBeATwa	a:[]	be:[]	dont:[]	twa:[]	
#BorisOut	boris:[]	out:[]	
#DigitalID	digital:[]	d:[]	i:[]	
#BigPharmaSalesman	big:[]	salesman:[]	pharma:[]	
#NHSVaccinemandates	s:[]	vaccinemandates:[]	h:[]	n:[]	
#FcukOffMichaelMartin	michael:[]	martin:[]	fcuk:[]	off:[]	
#StopAsianHate	stop:[]	asian:[]	hate:[]	
#DoNotGetV	not:[]	v:[]	get:[]	do:[]	
#DontBelieveTheHype	the:[]	hype:[]	believe:[]	dont:[]	
#GetVaccin	vaccin:[]	get:[]	
#EnoughIsEnou	enou:[]	is:[]	enough:[]	
#NursinghomeGenocide	genocide:[]	nursinghome:[]	
#VaccinesAreFree	are:[]	vaccines:[]	free:[]	
#StandupA	a:[]	standup:[]	
#andOVER	r:[]	e:[]	v:[]	and:[]	o:[]	
#UKMedia	u:[]	media:[]	k:[]	
#PoopyPantsBiden	biden:[]	pants:[]	poopy:[]	
#StaySafeStayHealthy	healthy:[]	safe:[]	stay:[]	
#ErieCounty	erie:[]	county:[]	
#DefundMandates	defund:[]	mandates:[]	
#BootLickers	lickers:[]	boot:[]	
#RemoveDonnelly	donnelly:[]	remove:[]	
#JoeandaHo	joeanda:[]	ho:[]	
#noplanB	b:[]	noplan:[]	
#FootieStories	stories:[]	footie:[]	
#PplArePublicHealthRisks	risks:[]	public:[]	are:[]	health:[]	ppl:[]	
#MumsieCulpepper	culpepper:[]	mumsie:[]	
#SouthAfricaVariant	africa:[]	south:[]	variant:[]	
#DrDogKiller	killer:[]	dog:[]	dr:[]	
#DoNotUseTheNHS	the:[]	not:[]	s:[]	use:[]	h:[]	do:[]	n:[]	
#NuVariant	nu:[]	variant:[]	
#SegregationDay	segregation:[]	day:[]	
#SesameStreet	street:[]	sesame:[]	
#VaccinePassports	vaccine:[]	passports:[]	
#VaccineMa	vaccine:[]	ma:[]	
#JairBolsonaro	jair:[]	bolsonaro:[]	
#TikTok	tok:[]	tik:[]	
#rdJab	rd:[]	jab:[]	
#TheGreatAmericanStrike	the:[]	strike:[]	american:[]	great:[]	
#MediaBlackout	blackout:[]	media:[]	
#ShareTheLove	love:[]	the:[]	share:[]	
#SinisterAgenda	sinister:[]	agenda:[]	
#HappeningNow	now:[]	happening:[]	
#standTogether	stand:[]	together:[]	
#NoToMandatoryVaccination	no:[]	to:[]	mandatory:[]	vaccination:[]	
#standwithItaly	standwith:[]	italy:[]	
#InTheMood	the:[]	mood:[]	in:[]	
#GodHelpUs	help:[]	god:[]	us:[]	
#PurebloodsUnited	united:[]	purebloods:[]	
#TogetherDeclarati	declarati:[]	together:[]	
#CoercionIsNotConsent	not:[]	coercion:[]	is:[]	consent:[]	
#PayCash	pay:[]	cash:[]	
#WorldWideWalkout	world:[]	wide:[]	walkout:[]	
#FutureFacts	future:[]	facts:[]	
#TheJigsUp	the:[]	jigs:[]	up:[]	
#EndGunViolence	gun:[]	end:[]	violence:[]	
#SaturdayMotivation	saturday:[]	motivation:[]	
#NationwideWalkout	nationwide:[]	walkout:[]	
#BoC	c:[]	bo:[]	
#DrJohnCampbell	john:[]	campbell:[]	dr:[]	
#NoMAGA	a:[]	no:[]	g:[]	m:[]	
#NappyHappy	happy:[]	nappy:[]	
#COVIDIsAirborne	airborne:[]	c:[]	d:[]	v:[]	i:[]	is:[]	o:[]	
#NoMasksInSchool	no:[]	school:[]	in:[]	masks:[]	
#BillGatesOfHell	gates:[]	of:[]	bill:[]	hell:[]	
#ThisIsAWa	a:[]	this:[]	wa:[]	is:[]	
#GreenNewDeal	new:[]	deal:[]	green:[]	
#LetsGoNicola	nicola:[]	go:[]	lets:[]	
#AnswerTheQuestion	the:[]	question:[]	answer:[]	
#LoyalLimbrick	limbrick:[]	loyal:[]	
#ChrisWallace	chris:[]	wallace:[]	
#QandA	a:[]	qand:[]	
#StandUp	up:[]	stand:[]	
#StandUn	un:[]	stand:[]	
#DanGone	dan:[]	gone:[]	
#QuestionEver	ever:[]	question:[]	
#HoldingTheLine	the:[]	holding:[]	line:[]	
#HumanRightsDay	rights:[]	day:[]	human:[]	
#UniteForfreedom	unite:[]	forfreedom:[]	
#MAGAt	a:[]	at:[]	g:[]	m:[]	
#VaccineHesitancy	vaccine:[]	hesitancy:[]	
#BlackMirror	mirror:[]	black:[]	
#ONPoli	poli:[]	n:[]	o:[]	
#VaxBloodMoney	money:[]	vax:[]	blood:[]	
#FJBiden	biden:[]	f:[]	j:[]	
#RepealTheBill	the:[]	bill:[]	repeal:[]	
#HeartAttack	attack:[]	heart:[]	
#FauciIsEvil	is:[]	evil:[]	fauci:[]	
#DictatorTrudeau	trudeau:[]	dictator:[]	
#StandTogether	stand:[]	together:[]	
#GreatBritain	britain:[]	great:[]	
#GermTheoryDeception	deception:[]	germ:[]	theory:[]	
#NoMedicalAparthe	no:[]	medical:[]	aparthe:[]	
#MeidadMini	mini:[]	meidad:[]	
#FreeItaly	free:[]	italy:[]	
#NoMedic	no:[]	medic:[]	
#TonightVMTV	tonight:[]	t:[]	v:[]	m:[]	
#exemptFromBS	b:[]	s:[]	from:[]	exempt:[]	
#StaySafe	safe:[]	stay:[]	
#ScrapTheA	the:[]	a:[]	scrap:[]	
#TogetherD	d:[]	together:[]	
#NoVacci	no:[]	vacci:[]	
#MyBody	body:[]	my:[]	
#WrongAgainPANDA	p:[]	a:[]	d:[]	again:[]	n:[]	wrong:[]	
#DoNotCompy	not:[]	do:[]	compy:[]	
#BizHour	biz:[]	hour:[]	
#WeNeedTruth	truth:[]	need:[]	we:[]	
#DoNotCompl	not:[]	compl:[]	do:[]	
#NazismIsBack	back:[]	nazism:[]	is:[]	
#SparsPandemic	pandemic:[]	spars:[]	
#NoPassSanitaire	no:[]	pass:[]	sanitaire:[]	
#openForAll	all:[]	for:[]	open:[]	
#NoFascism	no:[]	fascism:[]	
#GutsToStandUp	up:[]	to:[]	stand:[]	guts:[]	
#JustSayYes	yes:[]	say:[]	just:[]	
#WinterfellWillNotComply	not:[]	comply:[]	will:[]	winterfell:[]	
#chooseFreedom	freedom:[]	choose:[]	
#FordFailedKids	failed:[]	ford:[]	kids:[]	
#NoMorelies	no:[]	morelies:[]	
#TogetherStronger	stronger:[]	together:[]	
#HIStory	h:[]	i:[]	story:[]	
#NoTests	no:[]	tests:[]	
#FluSeason	season:[]	flu:[]	
#NaturalImmunityWorks	works:[]	natural:[]	immunity:[]	
#NudgeNudge	nudge:[]	
#DictaduraSanitaria	dictadura:[]	sanitaria:[]	
#NoMedicalSegregation	no:[]	medical:[]	segregation:[]	
#FreeAustria	austria:[]	free:[]	
#GoAway	away:[]	go:[]	
#StopTheShot	the:[]	stop:[]	shot:[]	
#HateCrime	crime:[]	hate:[]	
#WalesOneVoice	voice:[]	one:[]	wales:[]	
#AmericanJournal	journal:[]	american:[]	
#BodilyAutonomy	autonomy:[]	bodily:[]	
#NioForcedVaccination	nio:[]	forced:[]	vaccination:[]	
#WeAreManyTheyAreFew	are:[]	few:[]	many:[]	they:[]	we:[]	
#MeidasMini	mini:[]	meidas:[]	
#VaccinesWo	vaccines:[]	wo:[]	
#BuildBackBetter#Fraudci	better:[]	build:[]	back:[]	fraudci:[]	
#ChooseFreedom	freedom:[]	choose:[]	
#AleksandrLoekasjenko	aleksandr:[]	loekasjenko:[]	
#QuercetinZinc	quercetin:[]	zinc:[]	
#COVIDdeaths	ddeaths:[]	c:[]	v:[]	i:[]	o:[]	
#MandatoryVaccinations	vaccinations:[]	mandatory:[]	
#CovidCompassionNOW	covid:[]	w:[]	compassion:[]	n:[]	o:[]	
#ApartheidDay	apartheid:[]	day:[]	
#StandUpForFreedom	freedom:[]	for:[]	up:[]	stand:[]	
#HartGroup	hart:[]	group:[]	
#itIsOver	over:[]	is:[]	it:[]	
#TakeYourFkinMaskOff	take:[]	fkin:[]	your:[]	off:[]	mask:[]	
#VaccineAdverseEffects	effects:[]	vaccine:[]	adverse:[]	
#NoGreen	no:[]	green:[]	
#QunA	a:[]	qun:[]	
#humanRights	rights:[]	human:[]	
#PushBack	back:[]	push:[]	
#COVIDnearly	c:[]	v:[]	dnearly:[]	i:[]	o:[]	
#IwillNOTcomply	tcomply:[]	iwill:[]	n:[]	o:[]	
#NoMedicalTyranny	no:[]	medical:[]	tyranny:[]	
#BornFree	born:[]	free:[]	
#CanYouSeeItYet	can:[]	see:[]	yet:[]	it:[]	you:[]	
#FullNormality	normality:[]	full:[]	
#EnoughisEnough	enoughis:[]	enough:[]	
#ProtectWomenAndGi	gi:[]	and:[]	protect:[]	women:[]	
#ClimateCON	c:[]	climate:[]	n:[]	o:[]	
#NoMoreL	no:[]	more:[]	l:[]	
#ArrestHolohan	arrest:[]	holohan:[]	
#PapersPlease	please:[]	papers:[]	
#FightOSHAMandate	a:[]	mandate:[]	s:[]	h:[]	fight:[]	o:[]	
#EpicFail	fail:[]	epic:[]	
#YouNetflix	netflix:[]	you:[]	
#TheAnswerIsNO	the:[]	answer:[]	is:[]	n:[]	o:[]	
#AirForce	force:[]	air:[]	
#AntiHinduUnacademy	hindu:[]	unacademy:[]	anti:[]	
#SolutionsWatch	watch:[]	solutions:[]	
#WeWillNeverForget	never:[]	forget:[]	will:[]	we:[]	
#MyBodyMyChoi	choi:[]	body:[]	my:[]	
#FreedomsNZ	z:[]	freedoms:[]	n:[]	
#OntarioFirst	ontario:[]	first:[]	
#notoVaccinePassports	vaccine:[]	passports:[]	noto:[]	
#StopTh	th:[]	stop:[]	
#WeWillWin	will:[]	win:[]	we:[]	
#RiseUpAdelaide	adelaide:[]	up:[]	rise:[]	
#covidFlu	covid:[]	flu:[]	
#AnthonyFauci	fauci:[]	anthony:[]	
#InformedConse	informed:[]	conse:[]	
#NationalUprising	uprising:[]	national:[]	
#AmericanCrimeStory	crime:[]	american:[]	story:[]	
#BlackRock	rock:[]	black:[]	
#SayNoTo	no:[]	say:[]	to:[]	
#FluShot	flu:[]	shot:[]	
#TwitterSpace	twitter:[]	space:[]	
#WLDragnet	dragnet:[]	w:[]	l:[]	
#DomPas	pas:[]	dom:[]	
#NWOMaskSlaves	slaves:[]	w:[]	n:[]	mask:[]	o:[]	
#NonAuPasseDeLaHonte	de:[]	au:[]	honte:[]	la:[]	passe:[]	non:[]	
#NoHealt	no:[]	healt:[]	
#DearEarth	earth:[]	dear:[]	
#AbsolutelyMental	absolutely:[]	mental:[]	
#CanerCenter	center:[]	caner:[]	
#TogetherDeclaration#novaccinepasspo	declarationnovaccinepasspo:[]	together:[]	
#ChildTorture	torture:[]	child:[]	
#VerzetJeNu	verzet:[]	nu:[]	je:[]	
#MenInBlack	in:[]	men:[]	black:[]	
#XiVirus	xi:[]	virus:[]	
#TrmpAn	trmp:[]	an:[]	
#PeoplePowerJustSayNo	no:[]	say:[]	power:[]	just:[]	people:[]	
#weARRRpirate	a:[]	r:[]	rpirate:[]	we:[]	
#MurdochGutterMedia	gutter:[]	murdoch:[]	media:[]	
#reinstateJoelSmalley	reinstate:[]	smalley:[]	joel:[]	
#MedicalExperiments	medical:[]	experiments:[]	
#BotswanaVariant	variant:[]	botswana:[]	
#FactsNotFear	not:[]	facts:[]	fear:[]	
#DeepStates	deep:[]	states:[]	
#WorldWideDemo	world:[]	wide:[]	demo:[]	
#SafeZones	safe:[]	zones:[]	
#LeakyVaccine	vaccine:[]	leaky:[]	
#ScienceOverFiction	over:[]	fiction:[]	science:[]	
#TexasTaliban	taliban:[]	texas:[]	
#WhereIsPengShuai	peng:[]	is:[]	where:[]	shuai:[]	
#COVIDisAirb	c:[]	airb:[]	v:[]	i:[]	dis:[]	o:[]	
#StandUpHumanRights	rights:[]	up:[]	stand:[]	human:[]	
#ShiftingNarrative	narrative:[]	shifting:[]	
#WeStandWithAustria	with:[]	austria:[]	stand:[]	we:[]	
#JohnsonAndJohnson	and:[]	johnson:[]	
#vaccineSideEffect	side:[]	vaccine:[]	effect:[]	
#LongCovidKids	covid:[]	long:[]	kids:[]	
#HARTleaks	a:[]	r:[]	h:[]	tleaks:[]	
#OnPoli	poli:[]	on:[]	
#AntiMandates	mandates:[]	anti:[]	
#VaccineS	vaccine:[]	s:[]	
#GetYourFluShot	get:[]	your:[]	flu:[]	shot:[]	
#CovidDerangementSyndrome	covid:[]	syndrome:[]	derangement:[]	
#BorisMustGo	boris:[]	go:[]	must:[]	
#FreshResists	resists:[]	fresh:[]	
#VaxPassport	passport:[]	vax:[]	
#BigPha	big:[]	pha:[]	
#WeWillNotComply	not:[]	comply:[]	will:[]	we:[]	
#WorldEconomicForum	forum:[]	world:[]	economic:[]	
#DeathJabs	death:[]	jabs:[]	
#TheKarenandKyleshow	the:[]	kyleshow:[]	karenand:[]	
#GreenEnergy	green:[]	energy:[]	
#StopDiscriminating	stop:[]	discriminating:[]	
#GreaterGood	good:[]	greater:[]	
#NoMoreVariants	no:[]	more:[]	variants:[]	
#vaccineRegret	vaccine:[]	regret:[]	
#FlipFlopFAUCI	a:[]	c:[]	u:[]	f:[]	flop:[]	i:[]	flip:[]	
#MelbourneCup	melbourne:[]	cup:[]	
#JFKassassination	f:[]	j:[]	kassassination:[]	
#ARRESTUrsulaVonderLeyen	a:[]	r:[]	s:[]	t:[]	e:[]	vonder:[]	ursula:[]	leyen:[]	
#DenHaa	haa:[]	den:[]	
#NoMoreLockdown	no:[]	more:[]	lockdown:[]	
#IStandWithKyrie	with:[]	i:[]	kyrie:[]	stand:[]	
#ClimateChange	change:[]	climate:[]	
#EffettoNocebo	nocebo:[]	effetto:[]	
#noVaccineMandates	no:[]	vaccine:[]	mandates:[]	
#SayNoToDangerousInjections	injections:[]	no:[]	dangerous:[]	say:[]	to:[]	
#FireFauci	fire:[]	fauci:[]	
#WakeUpWorld	world:[]	wake:[]	up:[]	
#vaccineMandates	vaccine:[]	mandates:[]	
#BBCNolan	b:[]	c:[]	nolan:[]	
#LaGenteComeNoiNonMollaMai	mai:[]	la:[]	noi:[]	come:[]	gente:[]	molla:[]	non:[]	
#CovidVaxExpo	covid:[]	vax:[]	expo:[]	
#TrudeauNationalDisgrace	trudeau:[]	national:[]	disgrace:[]	
#UsForThem	for:[]	them:[]	us:[]	
#LasVegas	vegas:[]	las:[]	
#GunViolence	gun:[]	violence:[]	
#LeaveOurKidsA	a:[]	leave:[]	our:[]	kids:[]	
#ProtectOurChildren	children:[]	protect:[]	our:[]	
#EndVaccineMandate	mandate:[]	vaccine:[]	end:[]	
#StopAnti	stop:[]	anti:[]	
#NewBrighton	new:[]	brighton:[]	
#ClownVariant	variant:[]	clown:[]	
#VaccineM	vaccine:[]	m:[]	
#VaccineP	p:[]	vaccine:[]	
#SafeAndEffective	effective:[]	and:[]	safe:[]	
#SackSAGE	a:[]	s:[]	sack:[]	e:[]	g:[]	
#FreeKyle	kyle:[]	free:[]	
#BorisJohnsonMustGo	boris:[]	go:[]	must:[]	johnson:[]	
#JohnsonTheCorruptPM	p:[]	the:[]	corrupt:[]	johnson:[]	m:[]	
#NWOagenda	w:[]	n:[]	oagenda:[]	
#ClimateActionNow	now:[]	action:[]	climate:[]	
#ValueYourFreedom	freedom:[]	your:[]	value:[]	
#DefundTheMedia	the:[]	defund:[]	media:[]	
#nomaskMandates	nomask:[]	mandates:[]	
#HowDareYou	how:[]	you:[]	dare:[]	
#BatShitCrazy	bat:[]	shit:[]	crazy:[]	
#TheGrinch	the:[]	grinch:[]	
#NothingToFear	nothing:[]	to:[]	fear:[]	
#NoGreenPassObbli	no:[]	green:[]	pass:[]	obbli:[]	
#ClimateCrisis	crisis:[]	climate:[]	
#TheGreatGlobalPushback	pushback:[]	the:[]	global:[]	great:[]	
#StopTesting	stop:[]	testing:[]	
#SNPcorruption	s:[]	pcorruption:[]	n:[]	
#PremierLeague	league:[]	premier:[]	
#medicalApartheid	medical:[]	apartheid:[]	
#notCoincidence	not:[]	coincidence:[]	
#PandemicOfTheVaxxed	the:[]	vaxxed:[]	of:[]	pandemic:[]	
#ScottMorrison	scott:[]	morrison:[]	
#CovidVaccin	vaccin:[]	covid:[]	
#BoosterScam	scam:[]	booster:[]	
#ScumMedia	media:[]	scum:[]	
#RefuseToLose	refuse:[]	lose:[]	to:[]	
#EvilCCP	p:[]	c:[]	evil:[]	
#WarCrimes	crimes:[]	war:[]	
#covidCanada	covid:[]	canada:[]	
#LiftTheVeil	the:[]	veil:[]	lift:[]	
#AntiTyranny	tyranny:[]	anti:[]	
#ChrisS	s:[]	chris:[]	
#NaturalImmunity	natural:[]	immunity:[]	
#NotInTheMood	the:[]	not:[]	mood:[]	in:[]	
#NoVoterID	no:[]	d:[]	i:[]	voter:[]	
#vaxNazis	vax:[]	nazis:[]	
#GetFucked	get:[]	fucked:[]	
#MoreOfUs	more:[]	of:[]	us:[]	
#InternmentCampsAustralia	camps:[]	australia:[]	internment:[]	
#NBPoli	b:[]	poli:[]	n:[]	
#FascistOfTheDay	the:[]	of:[]	fascist:[]	day:[]	
#NoGreenpass	no:[]	greenpass:[]	
#TravisScott	travis:[]	scott:[]	
#CovidVicData	vic:[]	covid:[]	data:[]	
#DiedSuddenly	died:[]	suddenly:[]	
#CancelDougFord	cancel:[]	doug:[]	ford:[]	
#ResignBoris	boris:[]	resign:[]	
#EarlyTreatmentWorks	treatment:[]	works:[]	early:[]	
#AnasSarwar	anas:[]	sarwar:[]	
#VaccineSid	vaccine:[]	sid:[]	
#ResistanceUnited	united:[]	resistance:[]	
#PfizerGate	pfizer:[]	gate:[]	
#CDCs	cs:[]	c:[]	d:[]	
#vaccineSideEffects	effects:[]	side:[]	vaccine:[]	
#CrimesAgainstHumanity	against:[]	crimes:[]	humanity:[]	
#NoMeansNo	means:[]	no:[]	
#AllTrials	all:[]	trials:[]	
#StongerToge	stonger:[]	toge:[]	
#FireDeSantis	de:[]	santis:[]	fire:[]	
#WeSeeYou	see:[]	you:[]	we:[]	
#OrganizedCrime	organized:[]	crime:[]	
#SackJavid	sack:[]	javid:[]	
#SOSAustralia	s:[]	australia:[]	o:[]	
#GavinNewsom	gavin:[]	newsom:[]	
#BodyAutonomy	autonomy:[]	body:[]	
#PCRTests	p:[]	r:[]	tests:[]	c:[]	
#ProblemSolved	problem:[]	solved:[]	
#TheCorporation	the:[]	corporation:[]	
#DONOTComply	comply:[]	t:[]	d:[]	n:[]	o:[]	
#CovidPass	covid:[]	pass:[]	
#StandUpHumanRig	rig:[]	up:[]	stand:[]	human:[]	
#NZHellhole	hellhole:[]	z:[]	n:[]	
#wtpBLUE	b:[]	wtp:[]	e:[]	u:[]	l:[]	
#SliwaForMayor	mayor:[]	for:[]	sliwa:[]	
#SpikeProtein	protein:[]	spike:[]	
#SouthPark	south:[]	park:[]	
#GiuLeManiDaiBamb	giu:[]	le:[]	bamb:[]	mani:[]	dai:[]	
#DenHaag	den:[]	haag:[]	
#UslessEaters	eaters:[]	usless:[]	
#AustraliaHa	ha:[]	australia:[]	
#KrispyKreme	krispy:[]	kreme:[]	
#FreedomDay	freedom:[]	day:[]	
#facts#Truths	truths:[]	facts:[]	
#BeThisGuy	be:[]	this:[]	guy:[]	
#StopCo	stop:[]	co:[]	
#StopTheSpread	the:[]	stop:[]	spread:[]	
#BulgarianGovernment	government:[]	bulgarian:[]	
#FluFactFriday	fact:[]	friday:[]	flu:[]	
#AlexBerenson	alex:[]	berenson:[]	
#BigPharma	big:[]	pharma:[]	
#PrimeMinister	prime:[]	minister:[]	
#ItWasaScam	scam:[]	it:[]	wasa:[]	
#FightBackBetter	better:[]	back:[]	fight:[]	
#MustWatch	watch:[]	must:[]	
#NoVaccinePassPorts	no:[]	vaccine:[]	pass:[]	ports:[]	
#NoDigitalI	digital:[]	no:[]	i:[]	
#TrustTheScience	the:[]	trust:[]	science:[]	
#NoVaccinesPassport	no:[]	passport:[]	vaccines:[]	
#LISTENtoExperts	s:[]	t:[]	e:[]	nto:[]	i:[]	l:[]	experts:[]	
#SouthAustraliaMagistratesCourt	south:[]	magistrates:[]	australia:[]	court:[]	
#RareDisease	disease:[]	rare:[]	
#BigPharmaTyranny	big:[]	tyranny:[]	pharma:[]	
#AustraliaHasNotFallen	not:[]	fallen:[]	australia:[]	has:[]	
#GQPDomesticTer	ter:[]	domestic:[]	p:[]	q:[]	g:[]	
#TrendWorldWide	world:[]	wide:[]	trend:[]	
#EudraVigilence	vigilence:[]	eudra:[]	
#DELTAVa	a:[]	t:[]	d:[]	e:[]	va:[]	l:[]	
#WhitePrivilege	white:[]	privilege:[]	
#CriticalThinking	critical:[]	thinking:[]	
#LoveOneAnother	love:[]	another:[]	one:[]	
#PirateChain	chain:[]	pirate:[]	
#StarTrek	trek:[]	star:[]	
#ItalyProtests	protests:[]	italy:[]	
#PCRFraud	p:[]	r:[]	c:[]	fraud:[]	
#FakeNewsMedia	news:[]	fake:[]	media:[]	
#RemoveGerryHorkan	gerry:[]	horkan:[]	remove:[]	
#MichelleGoszko	goszko:[]	michelle:[]	
#PlayStation	play:[]	station:[]	
#NoMandatoryV	no:[]	v:[]	mandatory:[]	
#ConspiracyTheories	conspiracy:[]	theories:[]	
#ItIsNotAVaccine	a:[]	vaccine:[]	not:[]	is:[]	it:[]	
#CoronaMadness	madness:[]	corona:[]	
#AaronRodgers	aaron:[]	rodgers:[]	
#DrRobertMalone	robert:[]	malone:[]	dr:[]	
#ChampsElysees	champs:[]	elysees:[]	
#AntivaxPremier	premier:[]	antivax:[]	
#VaccinationIsNotCompulsary	compulsary:[]	not:[]	is:[]	vaccination:[]	
#ExposePfizer	pfizer:[]	expose:[]	
#BidenBorderVirus	border:[]	biden:[]	virus:[]	
#GlobalCovidNazis	covid:[]	global:[]	nazis:[]	
#WorldWideAwakening	world:[]	wide:[]	awakening:[]	
#CovidVaxExp	covid:[]	exp:[]	vax:[]	
#AuditAllStates	all:[]	audit:[]	states:[]	
#BigBrother	big:[]	brother:[]	
#MillionMaskMarch	million:[]	march:[]	mask:[]	
#MyoCarditis	myo:[]	carditis:[]	
#NoToDivision	division:[]	no:[]	to:[]	
#DeathCult	cult:[]	death:[]	
#VaccinesSaveLive	vaccines:[]	save:[]	live:[]	
#thWave	th:[]	wave:[]	
#DrBonnieHenry	henry:[]	bonnie:[]	dr:[]	
#RejectTheReset	the:[]	reject:[]	reset:[]	
#NovaccineMandates	novaccine:[]	mandates:[]	
#AntiPlandemic	plandemic:[]	anti:[]	
#CovidHo	covid:[]	ho:[]	
#VaccineManda	vaccine:[]	manda:[]	
#CovidTyranny	covid:[]	tyranny:[]	
#MasksSaveLives	lives:[]	save:[]	masks:[]	
#ArronRodgers	rodgers:[]	arron:[]	
#KillSho	sho:[]	kill:[]	
#TakeOffYo	take:[]	yo:[]	off:[]	
#NoJabsForKids	no:[]	for:[]	jabs:[]	kids:[]	
#BoycottPeterBurgers	peter:[]	boycott:[]	burgers:[]	
#StopPassSanitaire	stop:[]	pass:[]	sanitaire:[]	
#DemVoi	voi:[]	dem:[]	
#ToriesAreToast	toast:[]	tories:[]	are:[]	
#NoVaccinepassportsanywhere	no:[]	vaccinepassportsanywhere:[]	
#StongerTogether	stonger:[]	together:[]	
#RandyHillier	randy:[]	hillier:[]	
#SackBorisJohnson	sack:[]	boris:[]	johnson:[]	
#hOLDtHElINE	dt:[]	e:[]	el:[]	h:[]	i:[]	l:[]	n:[]	o:[]	
#CovidCommunism	covid:[]	communism:[]	
#SouthwestEmployees	southwest:[]	employees:[]	
#FamilyMeeting	family:[]	meeting:[]	
#VaccineHarm	vaccine:[]	harm:[]	
#NaziUrsulaVonderLeyen	nazi:[]	vonder:[]	ursula:[]	leyen:[]	
#NewYorkTimes	new:[]	times:[]	york:[]	
#NphetOutNow	now:[]	nphet:[]	out:[]	
#JusticeMatters	matters:[]	justice:[]	
#PiersCorbyn	corbyn:[]	piers:[]	
#NewJersey	new:[]	jersey:[]	
#JohnsonLiedPeopleDied	died:[]	johnson:[]	people:[]	lied:[]	
#ShameOnNaziAustralia	nazi:[]	shame:[]	australia:[]	on:[]	
#DefundThePolice	the:[]	defund:[]	police:[]	
#WinterOlympics	olympics:[]	winter:[]	
#LiveFreeOrDie	die:[]	or:[]	free:[]	live:[]	
#HoldFirm	firm:[]	hold:[]	
#NoNetZero	zero:[]	no:[]	net:[]	
#MichaelYeadon	michael:[]	yeadon:[]	
#EndTheMandates	the:[]	end:[]	mandates:[]	
#jaconfaArdern	ardern:[]	jaconfa:[]	
#LandOfTheFree	the:[]	of:[]	land:[]	free:[]	
#ThursdayNightClap	clap:[]	night:[]	thursday:[]	
#StopQRankzinnigheid	q:[]	stop:[]	rankzinnigheid:[]	
#ScienceSaves	saves:[]	science:[]	
#NHSPressure	s:[]	h:[]	pressure:[]	n:[]	
#PseudoScience	science:[]	pseudo:[]	
#BelgiansForFreedom	freedom:[]	for:[]	belgians:[]	
#BoycottSainsburys	sainsburys:[]	boycott:[]	
#LockupMichaelMartin	michael:[]	lockup:[]	martin:[]	
#AntiScience	science:[]	anti:[]	
#VanGran	van:[]	gran:[]	
#NYCMayorElect	c:[]	mayor:[]	y:[]	elect:[]	n:[]	
#LeaveOurKi	leave:[]	our:[]	ki:[]	
#TorySewageParty	tory:[]	party:[]	sewage:[]	
#BoosterClub	club:[]	booster:[]	
#ThatsNotHowThisWorks	how:[]	not:[]	works:[]	this:[]	thats:[]	
#CuyahogaCounty	cuyahoga:[]	county:[]	
#YorkProtest	york:[]	protest:[]	
#SayNoToTheJab	the:[]	no:[]	jab:[]	say:[]	to:[]	
#BelfastProtest	belfast:[]	protest:[]	
#CallItWhatItIs	call:[]	what:[]	is:[]	it:[]	
#DeSantis	de:[]	santis:[]	
#PlanDemic	demic:[]	plan:[]	
#GoldCoastNe	gold:[]	coast:[]	ne:[]	
#CovidScam	covid:[]	scam:[]	
#FluAwareness	awareness:[]	flu:[]	
#OntariosPrivatizedGovernment	government:[]	ontarios:[]	privatized:[]	
#BanC	c:[]	ban:[]	
#RayHadley	hadley:[]	ray:[]	
#StarWars	star:[]	wars:[]	
#ImpeachBiden	biden:[]	impeach:[]	
#DrHilary	dr:[]	hilary:[]	
#PuertoRicoDoesItBetter	better:[]	puerto:[]	does:[]	rico:[]	it:[]	
#ArrestBorisJohnson	arrest:[]	boris:[]	johnson:[]	
#NSWpol	wpol:[]	s:[]	n:[]	
#FactCheck	fact:[]	check:[]	
#ProtecttheChildren	protectthe:[]	children:[]	
#HumanRightsViola	viola:[]	rights:[]	human:[]	
#VAERSIndia	a:[]	r:[]	s:[]	e:[]	v:[]	india:[]	
#WashHands	hands:[]	wash:[]	
#NoBailouts	no:[]	bailouts:[]	
#WeLoveNovakDjokovic	love:[]	novak:[]	we:[]	djokovic:[]	
#CultOfCovid	covid:[]	cult:[]	of:[]	
#CovidTesting	covid:[]	testing:[]	
#SaveTheChildren	the:[]	children:[]	save:[]	
#NHSmandates	smandates:[]	h:[]	n:[]	
#BidenBorderCrisis	border:[]	biden:[]	crisis:[]	
#NoNakedNostrils	no:[]	nostrils:[]	naked:[]	
#NewYork	new:[]	york:[]	
#WorldwideDemons	worldwide:[]	demons:[]	
#QRcode	q:[]	rcode:[]	
#AntibodyDependentEnhancement	antibody:[]	enhancement:[]	dependent:[]	
#CovidIsNotGone	not:[]	covid:[]	is:[]	gone:[]	
#CyberBullying	cyber:[]	bullying:[]	
#NeverAgain	never:[]	again:[]	
#PoliceBrutality	police:[]	brutality:[]	
#CovidVacci	vacci:[]	covid:[]	
#NOTaVaccine	vaccine:[]	ta:[]	n:[]	o:[]	
#UniteNow	unite:[]	now:[]	
#VaccinationMandate	mandate:[]	vaccination:[]	
#NewWorldWorder	new:[]	world:[]	worder:[]	
#MelbourneProtest	protest:[]	melbourne:[]	
#EndTheFed	the:[]	fed:[]	end:[]	
#AntiVaxxer	vaxxer:[]	anti:[]	
#ArrestFauciNow	arrest:[]	now:[]	fauci:[]	
#MasksAreUseless	are:[]	useless:[]	masks:[]	
#BrandonAdministration	brandon:[]	administration:[]	
#NoLFTesting	no:[]	f:[]	testing:[]	l:[]	
#DEmask	emask:[]	d:[]	
#FactCheckTHIS	s:[]	fact:[]	t:[]	h:[]	i:[]	check:[]	
#VaccineRelated	vaccine:[]	related:[]	
#CBDCs	cs:[]	b:[]	c:[]	d:[]	
#AreYouAwakeYet	are:[]	yet:[]	awake:[]	you:[]	
#MelbourneRises	rises:[]	melbourne:[]	
#UKcolumn	u:[]	kcolumn:[]	
#NoMoreLies	no:[]	more:[]	lies:[]	
#BigGov	big:[]	gov:[]	
#GeneralStrike	general:[]	strike:[]	
#HelpOthersGetVaccinated	help:[]	get:[]	vaccinated:[]	others:[]	
#NeverVoteCon	never:[]	con:[]	vote:[]	
#NoGreenP	p:[]	no:[]	green:[]	
#StopTakin	takin:[]	stop:[]	
#VaccineColonialism	colonialism:[]	vaccine:[]	
#TeamCOVID	c:[]	d:[]	v:[]	i:[]	team:[]	o:[]	
#WEFOwned	e:[]	owned:[]	f:[]	w:[]	
#BareShelvesBiden	biden:[]	bare:[]	shelves:[]	
#VaccinObligatoire	vaccin:[]	obligatoire:[]	
#NoTimeToDie	die:[]	no:[]	to:[]	time:[]	
#TogetherDe	de:[]	together:[]	
#SkyPalace	palace:[]	sky:[]	
#MakeAmericaTrumpAgain	trump:[]	again:[]	make:[]	america:[]	
#KeepTheFaith	the:[]	keep:[]	faith:[]	
#ChildAbuse	abuse:[]	child:[]	
#JimJordan	jordan:[]	jim:[]	
#DonotComply	comply:[]	donot:[]	
#NoJabsForJobs	no:[]	jobs:[]	for:[]	jabs:[]	
#OhHellNo	no:[]	oh:[]	hell:[]	
#StopTheVaccineRollout	the:[]	vaccine:[]	rollout:[]	stop:[]	
#GodWins	wins:[]	god:[]	
#KidsVaccine	vaccine:[]	kids:[]	
#IceCube	ice:[]	cube:[]	
#BuyChapmans	chapmans:[]	buy:[]	
#NoVaccinePassExtension	no:[]	extension:[]	vaccine:[]	pass:[]	
#NoVaccineForMe	no:[]	vaccine:[]	me:[]	for:[]	
#DementiaJoe	joe:[]	dementia:[]	
#FourDayth	four:[]	dayth:[]	
#LeaveOurDNAalone	d:[]	aalone:[]	leave:[]	our:[]	n:[]	
#MailOnline	mail:[]	online:[]	
#StandTheHellUp	the:[]	up:[]	stand:[]	hell:[]	
#MedicalRape	rape:[]	medical:[]	
#UnsafeSchools	schools:[]	unsafe:[]	
#ItsNotAboutHealth	not:[]	about:[]	health:[]	its:[]	
#WeWillRememberThem	remember:[]	will:[]	them:[]	we:[]	
#UrsulaVaccinadator	ursula:[]	vaccinadator:[]	
#IGotBoosted	i:[]	boosted:[]	got:[]	
#NoDiscrimination	no:[]	discrimination:[]	
#SocialCreditScore	score:[]	social:[]	credit:[]	
#DrDeathHinshaw	hinshaw:[]	death:[]	dr:[]	
#LabLeak	leak:[]	lab:[]	
#TogetherDeclarat	declarat:[]	together:[]	
#CovidCult	covid:[]	cult:[]	
#FreeBelgium	free:[]	belgium:[]	
#PandemieEnde	ende:[]	pandemie:[]	
#NoNHSMandate	no:[]	mandate:[]	s:[]	h:[]	n:[]	
#WatchThis	watch:[]	this:[]	
#CovidVaccinatio	covid:[]	vaccinatio:[]	
#PremeditatedGenocide	premeditated:[]	genocide:[]	
#DefundCBC	b:[]	defund:[]	c:[]	
#ForYourHealth	for:[]	health:[]	your:[]	
#TrudeauDictatorship	trudeau:[]	dictatorship:[]	
#WarRoomPandemic	war:[]	pandemic:[]	room:[]	
#CovidUK	covid:[]	u:[]	k:[]	
#JohnsonVariant	variant:[]	johnson:[]	
#GoldSilverCurrency	gold:[]	currency:[]	silver:[]	
#TickTock	tock:[]	tick:[]	
#PublicHealth	public:[]	health:[]	
#PassSanitaire	pass:[]	sanitaire:[]	
#MandateNotALaw	a:[]	not:[]	mandate:[]	law:[]	
#OmicronVarient	omicron:[]	varient:[]	
#NomandatoryVaccines	vaccines:[]	nomandatory:[]	
#WakeUpEverybody	everybody:[]	wake:[]	up:[]	
#AntiVaccine	vaccine:[]	anti:[]	
#FreedomLovers	freedom:[]	lovers:[]	
#StayHome	home:[]	stay:[]	
#DefundTheMandates	the:[]	defund:[]	mandates:[]	
#TorySleaze	tory:[]	sleaze:[]	
#NoCovidTyranny	no:[]	covid:[]	tyranny:[]	
#MaskofTheBeast	the:[]	beast:[]	maskof:[]	
#DreamteamLowLands	dreamteam:[]	low:[]	lands:[]	
#DefyMandates	defy:[]	mandates:[]	
#CovidVa	covid:[]	va:[]	
#FreedomDecl	decl:[]	freedom:[]	
#WeDontNeedTheUN	the:[]	u:[]	need:[]	n:[]	dont:[]	we:[]	
#ReInstateBernie	instate:[]	re:[]	bernie:[]	
#AgeOfCorruption	of:[]	corruption:[]	age:[]	
#RichardRowe	richard:[]	rowe:[]	
#GreenpassObbligatorio	greenpass:[]	obbligatorio:[]	
#CaseAdemic	ademic:[]	case:[]	
#FBRparty	b:[]	rparty:[]	f:[]	
#BreakingNews	news:[]	breaking:[]	
#EndEmergencyPowers	emergency:[]	end:[]	powers:[]	
#DisasterPolitics	politics:[]	disaster:[]	
#HarryStyles	harry:[]	styles:[]	
#DublinProtest	dublin:[]	protest:[]	
#LiberalLogic	logic:[]	liberal:[]	
#DoNOTComply	comply:[]	t:[]	do:[]	n:[]	o:[]	
#AstridStuckelberger	stuckelberger:[]	astrid:[]	
#LawAndOrder	law:[]	and:[]	order:[]	
#BacktoNormal	normal:[]	backto:[]	
#ConcentrationCamps	camps:[]	concentration:[]	
#StopTheJab	the:[]	stop:[]	jab:[]	
#DemocratsDeliver	democrats:[]	deliver:[]	
#TheyWillNotDivideUs	not:[]	will:[]	divide:[]	us:[]	they:[]	
#FirePaulReid	fire:[]	reid:[]	paul:[]	
#StopTheVaccinePassports	the:[]	vaccine:[]	stop:[]	passports:[]	
#DoNotStaySilent	silent:[]	not:[]	do:[]	stay:[]	
#FreedomofChoice	freedomof:[]	choice:[]	
#SajidJavidOut	sajid:[]	javid:[]	out:[]	
#ForcedQuarantine	forced:[]	quarantine:[]	
#InformationWar	war:[]	information:[]	
#WeWill	will:[]	we:[]	
#SoylentGreenNewDeal	new:[]	deal:[]	green:[]	soylent:[]	
#LeaveTheKidsAlone	the:[]	alone:[]	leave:[]	kids:[]	
#CardiacArrest	arrest:[]	cardiac:[]	
#SydneyProtest	sydney:[]	protest:[]	
#IsraeliApartheid	apartheid:[]	israeli:[]	
#FreshWomen	fresh:[]	women:[]	
#NoPan	no:[]	pan:[]	
#WarrenWilhelm	wilhelm:[]	warren:[]	
#NoPlanetB	no:[]	b:[]	planet:[]	
#WhyAreTheyDoingThis	doing:[]	are:[]	this:[]	why:[]	they:[]	
#EndLockdownNow	now:[]	lockdown:[]	end:[]	
#SayNoToCommunism	no:[]	say:[]	communism:[]	to:[]	
#PlagueSpreaders	spreaders:[]	plague:[]	
#VaccinePasspor	vaccine:[]	passpor:[]	
#DemCast	cast:[]	dem:[]	
#TorySleazeParty	tory:[]	party:[]	sleaze:[]	
#BringBackTheFreeWorld	the:[]	world:[]	bring:[]	back:[]	free:[]	
#NoPlanB	no:[]	b:[]	plan:[]	
#DontVax	vax:[]	dont:[]	
#vaccineSid	vaccine:[]	sid:[]	
#TheNewWorldOrder	the:[]	new:[]	world:[]	order:[]	
#CovidCabal	covid:[]	cabal:[]	
#CovidPanto	panto:[]	covid:[]	
#RiccardoBosi	riccardo:[]	bosi:[]	
#DrEvil	evil:[]	dr:[]	
#NaziDorsey	nazi:[]	dorsey:[]	
#LoveC	love:[]	c:[]	
#TheresaMay	may:[]	theresa:[]	
#IStandWithCarers	with:[]	i:[]	stand:[]	carers:[]	
#DemocracyIsDead	dead:[]	is:[]	democracy:[]	
#GeriatricGenX	gen:[]	x:[]	geriatric:[]	
#WorldFreedomRally	world:[]	freedom:[]	rally:[]	
#ZeroCovid	zero:[]	covid:[]	
#SaveAustralia	save:[]	australia:[]	
#CyrilRamaphosa	ramaphosa:[]	cyril:[]	
#ImpeachBidenNow	biden:[]	impeach:[]	now:[]	
#ChristianErickson	erickson:[]	christian:[]	
#TeamHalo	team:[]	halo:[]	
#ResignJacind	jacind:[]	resign:[]	
#WeDoNotConsent	not:[]	do:[]	consent:[]	we:[]	
#NoGre	no:[]	gre:[]	
#UniteWorldwide	unite:[]	worldwide:[]	
#BillGates	gates:[]	bill:[]	
#FetchYourBody	fetch:[]	your:[]	body:[]	
#TestingNotLaw	not:[]	law:[]	testing:[]	
#PfizerExposed	exposed:[]	pfizer:[]	
#NOCovidVaccineForChildren	vaccine:[]	covid:[]	children:[]	for:[]	n:[]	o:[]	
#LestWeForget	forget:[]	lest:[]	we:[]	
#BogusVaccine	bogus:[]	vaccine:[]	
#FreedomOverFear	over:[]	freedom:[]	fear:[]	
#FreedomIsEverything	freedom:[]	is:[]	everything:[]	
#SaveSport	save:[]	sport:[]	
#StopTheShots	the:[]	stop:[]	shots:[]	
#NaturallyImmunity	naturally:[]	immunity:[]	
#CovidIsNotOver	over:[]	not:[]	covid:[]	is:[]	
#NewVariant	new:[]	variant:[]	
#TrustMe	trust:[]	me:[]	
#COVIDvaccine	c:[]	v:[]	i:[]	dvaccine:[]	o:[]	
#CriticalRaceTheory	race:[]	critical:[]	theory:[]	
#TheGreatAwaking	the:[]	awaking:[]	great:[]	
#JeffreyEpstein	epstein:[]	jeffrey:[]	
#GlobalCrisis	crisis:[]	global:[]	
#SurvivorshipBias	survivorship:[]	bias:[]	
#IgnoreThem	ignore:[]	them:[]	
#ndAm	nd:[]	am:[]	
#VeteransDay	veterans:[]	day:[]	
#MasksNotLaw	not:[]	law:[]	masks:[]	
#LetsGoBran	bran:[]	go:[]	lets:[]	
#FauciLiedMillionsDied	millions:[]	died:[]	fauci:[]	lied:[]	
#WeDoNotConsen	not:[]	consen:[]	do:[]	we:[]	
#NoJabNoJob	no:[]	jab:[]	job:[]	
#LongIsland	island:[]	long:[]	
#TampaGeneral	general:[]	tampa:[]	
#ScumVillainSelfSavingSystem	saving:[]	system:[]	villain:[]	self:[]	scum:[]	
#standFirm	firm:[]	stand:[]	
#VaccineAdverseReactions	vaccine:[]	reactions:[]	adverse:[]	
#NoVa	no:[]	va:[]	
#BernieWON	bernie:[]	w:[]	n:[]	o:[]	
#ProLife	pro:[]	life:[]	
#ArrestMichaelMartin	michael:[]	arrest:[]	martin:[]	
#UcantComeInHere	here:[]	in:[]	ucant:[]	come:[]	
#SanFrancisco	francisco:[]	san:[]	
#CommonSense	common:[]	sense:[]	
#AustralianOpen	australian:[]	open:[]	
#FLevine	levine:[]	f:[]	
#VaccinAction	vaccin:[]	action:[]	
#DancingNurses	dancing:[]	nurses:[]	
#ONpoli	npoli:[]	o:[]	
#WeWillAllBeTher	all:[]	be:[]	will:[]	ther:[]	we:[]	
#PeopleHoldThePower	the:[]	power:[]	people:[]	hold:[]	
#RejectNaziCovidVaxPass	nazi:[]	covid:[]	pass:[]	reject:[]	vax:[]	
#NotSafeorEffective	effective:[]	not:[]	safeor:[]	
#StopCOVIDDeaths	c:[]	d:[]	stop:[]	v:[]	i:[]	deaths:[]	o:[]	
#JohnWaters	waters:[]	john:[]	
#VariantScam	variant:[]	scam:[]	
#VariantsAreBullshiiiit	bullshiiiit:[]	are:[]	variants:[]	
#ProtectTheChildren	the:[]	children:[]	protect:[]	
#StandYourGround	ground:[]	your:[]	stand:[]	
#JustSayNo	no:[]	say:[]	just:[]	
#FreedomNOW	freedom:[]	w:[]	n:[]	o:[]	
#IrishGove	gove:[]	irish:[]	
#NoMedi	no:[]	medi:[]	
#AstraZeneca	zeneca:[]	astra:[]	
#GoAustraliaGo	go:[]	australia:[]	
#BanCovidVax	covid:[]	vax:[]	ban:[]	
#WorldwideDemonstration	worldwide:[]	demonstration:[]	
#TedrosAdhanom	tedros:[]	adhanom:[]	
#RuralHealth	rural:[]	health:[]	
#arrestBillGates	gates:[]	arrest:[]	bill:[]	
#GlobalFraud	fraud:[]	global:[]	
#ThisEndsWhenYouSayItDoes	does:[]	ends:[]	this:[]	say:[]	it:[]	when:[]	you:[]	
#CovidVaccineVictims	vaccine:[]	covid:[]	victims:[]	
#LockHerUp	her:[]	lock:[]	up:[]	
#NotInMyName	not:[]	in:[]	name:[]	my:[]	
#DoomPorn	doom:[]	porn:[]	
#BurningTheMask	the:[]	burning:[]	mask:[]	
#DeltaVariant	variant:[]	delta:[]	
#NoVaccineApartheid	no:[]	vaccine:[]	apartheid:[]	
#JoeRogan	joe:[]	rogan:[]	
#AustraliaProtests	protests:[]	australia:[]	
#StrengthInNumbers	strength:[]	in:[]	numbers:[]	
#OmnicronVariant	omnicron:[]	variant:[]	
#CrashTheSystem	the:[]	system:[]	crash:[]	
#LetsGoBrandon	brandon:[]	go:[]	lets:[]	
#reinstateDarrenofPlymouth	reinstate:[]	plymouth:[]	darrenof:[]	
#MasksDoNotWork	not:[]	work:[]	masks:[]	do:[]	
#JustSayNO	say:[]	just:[]	n:[]	o:[]	
#COINversation	c:[]	nversation:[]	i:[]	o:[]	
#DeprogramYourself	deprogram:[]	yourself:[]	
#CovidWar	covid:[]	war:[]	
#MagdelenaAndersson	andersson:[]	magdelena:[]	
#FrenchPolynesia	polynesia:[]	french:[]	
#CovidVariant	covid:[]	variant:[]	
#DisbandNphet	nphet:[]	disband:[]	
#AustraliaHasFall	fall:[]	australia:[]	has:[]	
#ShoppersDrugMart	mart:[]	shoppers:[]	drug:[]	
#IStandwithItaly	i:[]	standwith:[]	italy:[]	
#PrayForAllLeaders	all:[]	for:[]	leaders:[]	pray:[]	
#KidRock	rock:[]	kid:[]	
#stopLying	stop:[]	lying:[]	
#ScotlandTheSlave	slave:[]	the:[]	scotland:[]	
#PanNeverEndum	endum:[]	never:[]	pan:[]	
#NoVaccinPassports	vaccin:[]	no:[]	passports:[]	
#ProCOVID	c:[]	d:[]	v:[]	i:[]	pro:[]	o:[]	
#NuremburgCode	code:[]	nuremburg:[]	
#PoopyPants	pants:[]	poopy:[]	
#PeaceGardens	gardens:[]	peace:[]	
#DevilsAdvocate	devils:[]	advocate:[]	
#MikeFisher	mike:[]	fisher:[]	
#ReinstateBernie	bernie:[]	reinstate:[]	
#QuarantineCamps	camps:[]	quarantine:[]	
#TraitorTrudeau	traitor:[]	trudeau:[]	
#AnaCondYa	ana:[]	ya:[]	cond:[]	
#WearAFknNappy	a:[]	fkn:[]	wear:[]	nappy:[]	
#WheresGavinNewsom	wheres:[]	gavin:[]	newsom:[]	
#LatestNews	news:[]	latest:[]	
#DoD	d:[]	do:[]	
#VirtuallySignal	virtually:[]	signal:[]	
#ProMengele	mengele:[]	pro:[]	
#VaxBullies	bullies:[]	vax:[]	
#UsForThemUK	u:[]	for:[]	them:[]	k:[]	us:[]	
#GetVa	get:[]	va:[]	
#SaveOurChildren	children:[]	save:[]	our:[]	
#HandsOffOurChildren	hands:[]	children:[]	our:[]	off:[]	
#AntiClotshot	clotshot:[]	anti:[]	
#FcukNphet	nphet:[]	fcuk:[]	
#FauciLiedDogsDied	dogs:[]	died:[]	fauci:[]	lied:[]	
#SaveYourChildren	children:[]	save:[]	your:[]	
#DrShillary	shillary:[]	dr:[]	
#MelbourneProte	prote:[]	melbourne:[]	
#VaxandWin	vaxand:[]	win:[]	
#ChrisWhitty	chris:[]	whitty:[]	
#UnJabbed	jabbed:[]	un:[]	
#NoSegregation	no:[]	segregation:[]	
#BidenBoom	biden:[]	boom:[]	
#omiCON	c:[]	omi:[]	n:[]	o:[]	
#DoN	do:[]	n:[]	
#DnaHarvesting	harvesting:[]	dna:[]	
#WeAreOneButWeAreMany	but:[]	are:[]	one:[]	many:[]	we:[]	
#NurembergCode	code:[]	nuremberg:[]	
#LeaveTheKi	the:[]	leave:[]	ki:[]	
#SuperSpreader	super:[]	spreader:[]	
#NoMedicalCoercion	no:[]	medical:[]	coercion:[]	
#UrsulavonderLeyen	ursulavonder:[]	leyen:[]	
#COVvaxx	c:[]	vvaxx:[]	o:[]	
#YellowCard	yellow:[]	card:[]	
#WatChe	che:[]	wat:[]	
#MyBod	bod:[]	my:[]	
#CrimesAg	ag:[]	crimes:[]	
#COVIDVaccineInjuries	vaccine:[]	c:[]	d:[]	injuries:[]	v:[]	i:[]	o:[]	
#NotInTheMoodForVaccinePa	the:[]	pa:[]	vaccine:[]	not:[]	mood:[]	in:[]	for:[]	
#BorisUnfitPM	p:[]	boris:[]	unfit:[]	m:[]	
#DictatorDans	dictator:[]	dans:[]	
#CovidIdiots	covid:[]	idiots:[]	
#CivilWar	civil:[]	war:[]	
#NikolaiPetrovsky	petrovsky:[]	nikolai:[]	
#UniteForFreedom	freedom:[]	unite:[]	for:[]	
#ClownShow	show:[]	clown:[]	
#NoNewWorldOrder	new:[]	no:[]	world:[]	order:[]	
#GetBoostedNow	now:[]	get:[]	boosted:[]	
#NurembergTrialsForCovid	covid:[]	trials:[]	nuremberg:[]	for:[]	
#COVidiots	c:[]	vidiots:[]	o:[]	
#TEdit	t:[]	edit:[]	
#PassofShame	shame:[]	passof:[]	
#TheFinalSolution	the:[]	solution:[]	final:[]	
#AntiVax	vax:[]	anti:[]	
#IWillNotCom	com:[]	not:[]	will:[]	i:[]	
#WorldClassAthletes	world:[]	athletes:[]	class:[]	
#DoNotFear	not:[]	do:[]	fear:[]	
#NazismisBack	back:[]	nazismis:[]	
#PaidVaxPushers	paid:[]	pushers:[]	vax:[]	
#GreenpassObligatorio	greenpass:[]	obligatorio:[]	
#australianNurse	nurse:[]	australian:[]	
#ResistNWO	w:[]	resist:[]	n:[]	o:[]	
#GhislaineMaxwellTria	tria:[]	maxwell:[]	ghislaine:[]	
#CoronavirusAct	act:[]	coronavirus:[]	
#SocialDistance	distance:[]	social:[]	
#JoinTogether	join:[]	together:[]	
#CdnMediaFailed	failed:[]	media:[]	cdn:[]	
#MassivePlannedDepopulation	massive:[]	planned:[]	depopulation:[]	
#JailSonjaTerstra	sonja:[]	terstra:[]	jail:[]	
#antiVaxxer	vaxxer:[]	anti:[]	
#ToryLiars	tory:[]	liars:[]	
#PCRtest	p:[]	c:[]	rtest:[]	
#NoToTyranny	no:[]	tyranny:[]	to:[]	
#PassTheBill	the:[]	pass:[]	bill:[]	
#FightFlu	flu:[]	fight:[]	
#BioTerrorism	terrorism:[]	bio:[]	
#NoVaccineMandate	no:[]	mandate:[]	vaccine:[]	
#EveningStandard	standard:[]	evening:[]	
#AshleyMoody	ashley:[]	moody:[]	
#EndTheScam	the:[]	scam:[]	end:[]	
#ArrestBoris	arrest:[]	boris:[]	
#NHSCrisis	s:[]	crisis:[]	h:[]	n:[]	
#sayNO	say:[]	n:[]	o:[]	
#IvermectinForParasites	for:[]	parasites:[]	ivermectin:[]	
#BusinessModel	business:[]	model:[]	
#PeoplebeinginJected	jected:[]	peoplebeingin:[]	
#StreetYouGrewUpOn	street:[]	up:[]	grew:[]	you:[]	on:[]	
#UsforThe	the:[]	usfor:[]	
#ShameOnNaziAustria	nazi:[]	shame:[]	austria:[]	on:[]	
#StateFarm	farm:[]	state:[]	
#MasksWork	work:[]	masks:[]	
#CzechRepublic	republic:[]	czech:[]	
#NewBlueOntario	new:[]	blue:[]	ontario:[]	
#ClownPants	pants:[]	clown:[]	
#ThrowAwayYourMasks	away:[]	throw:[]	masks:[]	your:[]	
#FreedomInternet	freedom:[]	internet:[]	
#JohnsonOut	johnson:[]	out:[]	
#VaccineFraud	vaccine:[]	fraud:[]	
#GunnerPuke	puke:[]	gunner:[]	
#ConstitutionalViolation	violation:[]	constitutional:[]	
#VaccineApa	vaccine:[]	apa:[]	
#ArrestJacinda	jacinda:[]	arrest:[]	
#FinancialFreedom	freedom:[]	financial:[]	
#SeekstHisKingdom	his:[]	seekst:[]	kingdom:[]	
#GodIsLove	love:[]	is:[]	god:[]	
#CovidFraud	covid:[]	fraud:[]	
#NOVaccinePassportsAnywhere	vaccine:[]	passports:[]	anywhere:[]	n:[]	o:[]	
#NoMedicalTyrranny	no:[]	medical:[]	tyrranny:[]	
#BackAlleyButchers	butchers:[]	back:[]	alley:[]	
#SpeakerPelosi	speaker:[]	pelosi:[]	
#PedsID	peds:[]	d:[]	i:[]	
#YellowCardScheme	scheme:[]	yellow:[]	card:[]	
#ArrestMichie	arrest:[]	michie:[]	
#ThisRightHere	here:[]	this:[]	right:[]	
#NationwideShutdown	nationwide:[]	shutdown:[]	
#ChrisTisKing	chris:[]	king:[]	tis:[]	
#NonAuPassDeLaHont	de:[]	au:[]	la:[]	pass:[]	non:[]	hont:[]	
#TaxChurches	tax:[]	churches:[]	
#WeResist	resist:[]	we:[]	
#sayNo	no:[]	say:[]	
#GoAustralia	go:[]	australia:[]	
#DrHi	hi:[]	dr:[]	
#FreedomTogether	freedom:[]	together:[]	
#KillerVaccines	vaccines:[]	killer:[]	
#ResistFa	resist:[]	fa:[]	
#FreeVictoria	victoria:[]	free:[]	
#VaccineHolocaust	vaccine:[]	holocaust:[]	
#ChrisskyMallRant	rant:[]	mall:[]	chrissky:[]	
#EndSARSMemorial	a:[]	r:[]	s:[]	end:[]	memorial:[]	
#GhislaineMaxwellTrial	maxwell:[]	trial:[]	ghislaine:[]	
#SNPBadForScotland	p:[]	s:[]	bad:[]	for:[]	n:[]	scotland:[]	
#VirginiaElection	election:[]	virginia:[]	
#KilltheBill	bill:[]	killthe:[]	
#GreatFinancialReset	financial:[]	reset:[]	great:[]	
#JusticeForKartik	for:[]	kartik:[]	justice:[]	
#CVvaccinesdontwork	c:[]	vvaccinesdontwork:[]	
#AlexanderShallenberg	alexander:[]	shallenberg:[]	
#ErinOToole	toole:[]	erin:[]	o:[]	
#SocialCreditSystem	system:[]	social:[]	credit:[]	
#YouAreLivingALie	a:[]	living:[]	are:[]	lie:[]	you:[]	
#WilliamsandSonoma	williamsand:[]	sonoma:[]	
#BlueWarriors	blue:[]	warriors:[]	
#CoverUp	cover:[]	up:[]	
#VaccineMand	vaccine:[]	mand:[]	
#StopTheVaccine	the:[]	vaccine:[]	stop:[]	
#StopThisNow	stop:[]	now:[]	this:[]	
#ClwydWest	west:[]	clwyd:[]	
#ManifsNovembre	manifs:[]	novembre:[]	
#LikeForever	like:[]	forever:[]	
#TriesteResiste	trieste:[]	resiste:[]	
#SackDan	dan:[]	sack:[]	
#GRegel	g:[]	regel:[]	
#MakeReady	ready:[]	make:[]	
#PaperMasksDontW	paper:[]	w:[]	masks:[]	dont:[]	
#NoID	no:[]	d:[]	i:[]	
#FordFail	fail:[]	ford:[]	
#BoosterShots	shots:[]	booster:[]	
#KidsRock	rock:[]	kids:[]	
#antiVaxxers	vaxxers:[]	anti:[]	
#BeStrongANDCourageous	a:[]	strong:[]	be:[]	courageous:[]	d:[]	n:[]	
#NeverTrustJWR	trust:[]	never:[]	r:[]	w:[]	j:[]	
#NovakDjokovic	novak:[]	djokovic:[]	
#FloydMayweather	mayweather:[]	floyd:[]	
#NoGr	no:[]	gr:[]	
#CovidVaccine	vaccine:[]	covid:[]	
#NoGreenPas	no:[]	pas:[]	green:[]	
#MattHancock	hancock:[]	matt:[]	
#ArrestFau	arrest:[]	fau:[]	
#WearAMask	a:[]	wear:[]	mask:[]	
#ChinaVirus	china:[]	virus:[]	
#BoycottMcDonalds	mc:[]	donalds:[]	boycott:[]	
#WeStandTogether	stand:[]	together:[]	we:[]	
#WeWin	win:[]	we:[]	
#HoganTellsTheFansToShoveIt	the:[]	tells:[]	hogan:[]	it:[]	to:[]	shove:[]	fans:[]	
#WeWil	wil:[]	we:[]	
#ConspiracyFact	fact:[]	conspiracy:[]	
#TideTurned	tide:[]	turned:[]	
#SpectorTheShill	the:[]	shill:[]	spector:[]	
#WeWillNotComp	comp:[]	not:[]	will:[]	we:[]	
#DepopulationAgenda	depopulation:[]	agenda:[]	
#NoToStateMandatedMedicine	no:[]	medicine:[]	state:[]	to:[]	mandated:[]	
#NoVaccinepassports	no:[]	vaccinepassports:[]	
#FridayFeeling	friday:[]	feeling:[]	
#FreedomofChoise	freedomof:[]	choise:[]	
#SturgeonEffect	effect:[]	sturgeon:[]	
#ClimateGate	gate:[]	climate:[]	
#TheJabMustBeStopped	the:[]	stopped:[]	be:[]	must:[]	jab:[]	
#NoVaccinePassportsAnywhe	no:[]	vaccine:[]	anywhe:[]	passports:[]	
#doNotComply	not:[]	comply:[]	do:[]	
#DoSomething	do:[]	something:[]	
#ArrestGates	gates:[]	arrest:[]	
#ReclaimTheLine	the:[]	line:[]	reclaim:[]	
#JoeBiden	biden:[]	joe:[]	
#CovidVaccineMandates	vaccine:[]	covid:[]	mandates:[]	
#NancyPelosi	nancy:[]	pelosi:[]	
#OurGovernment	government:[]	our:[]	
#ThisTooShallPass	pass:[]	too:[]	this:[]	shall:[]	
#MaskMandates	mandates:[]	mask:[]	
#WeDoNotComply	not:[]	comply:[]	do:[]	we:[]	
#ScumMediaLiars	liars:[]	media:[]	scum:[]	
#TrudeauIsTrash	trudeau:[]	is:[]	trash:[]	
#BrettSutton	sutton:[]	brett:[]	
#GhislaneMaxwell	ghislane:[]	maxwell:[]	
#ResignHinshaw	hinshaw:[]	resign:[]	
#AmericaSur	sur:[]	america:[]	
#AlphabetSwamp	alphabet:[]	swamp:[]	
#TrumpVirus	trump:[]	virus:[]	
#holdTheLine	the:[]	line:[]	hold:[]	
#FuckYouJoeBiden	biden:[]	joe:[]	fuck:[]	you:[]	
#NaziAustria	nazi:[]	austria:[]	
#IrelandFreedomDay	freedom:[]	day:[]	ireland:[]	
#GatesDevelopedMarkOfTheBeast	the:[]	gates:[]	of:[]	beast:[]	developed:[]	mark:[]	
#NoMasks	no:[]	masks:[]	
#NoMa	no:[]	ma:[]	
#NoMe	no:[]	me:[]	
#RandomActsOfNonCompliance	random:[]	compliance:[]	of:[]	non:[]	acts:[]	
#FJoeBiden	biden:[]	joe:[]	f:[]	
#NoLo	no:[]	lo:[]	
#VaccineScam	vaccine:[]	scam:[]	
#McKinseys	mc:[]	kinseys:[]	
#FortStJohn	st:[]	john:[]	fort:[]	
#ProChoice	choice:[]	pro:[]	
#TimeToTakeBackWhatIsOurs	take:[]	ours:[]	what:[]	back:[]	is:[]	to:[]	time:[]	
#RepealtheCoronavi	repealthe:[]	coronavi:[]	
#WeCanRestoreTheOC	the:[]	can:[]	c:[]	restore:[]	we:[]	o:[]	
#NewZealanders	zealanders:[]	new:[]	
#BorisJohnson	boris:[]	johnson:[]	
#RememberanceDay	rememberance:[]	day:[]	
#RacistJoe	joe:[]	racist:[]	
#ThrowbackThursday	thursday:[]	throwback:[]	
#IwillNOTComply	comply:[]	t:[]	iwill:[]	n:[]	o:[]	
#PanAfricanism	africanism:[]	pan:[]	
#MasksDontWork	work:[]	masks:[]	dont:[]	
#DefendDemocracy	defend:[]	democracy:[]	
#QuarantineLife	quarantine:[]	life:[]	
#NoVaccinePasssports	no:[]	vaccine:[]	passsports:[]	
#novaccinepassportsANYWHERE	a:[]	novaccinepassports:[]	r:[]	e:[]	w:[]	h:[]	y:[]	n:[]	
#PedoJoes	joes:[]	pedo:[]	
#NYTimes	times:[]	y:[]	n:[]	
#MassNonCompliance	compliance:[]	mass:[]	non:[]	
#NoMoreLockd	no:[]	more:[]	lockd:[]	
#StopTheTyranny	the:[]	tyranny:[]	stop:[]	
#FauciGate	gate:[]	fauci:[]	
#GetBo	get:[]	bo:[]	
#NoNewNormal	normal:[]	new:[]	no:[]	
#FollowTheScience	the:[]	science:[]	follow:[]	
#COVIDDisinformation	c:[]	d:[]	v:[]	i:[]	disinformation:[]	o:[]	
#HealthCare	health:[]	care:[]	
#DitchTheMask	the:[]	ditch:[]	mask:[]	
#IStandWithBikies	with:[]	bikies:[]	i:[]	stand:[]	
#LiveFeed	feed:[]	live:[]	
#WakandaForever	wakanda:[]	forever:[]	
#AmericaCentral	central:[]	america:[]	
#ItalyUnderDidactorship	under:[]	italy:[]	didactorship:[]	
#RememberPolio	remember:[]	polio:[]	
#WhiteSupremacy	white:[]	supremacy:[]	
#noApartheid	no:[]	apartheid:[]	
#MilanVerona	milan:[]	verona:[]	
#MsM	ms:[]	m:[]	
#YouGov	you:[]	gov:[]	
#VaccineSideE	side:[]	vaccine:[]	e:[]	
#ItalianRes	res:[]	italian:[]	
#StopAntivaxxers	stop:[]	antivaxxers:[]	
#IWillNOTComply	comply:[]	t:[]	will:[]	i:[]	n:[]	o:[]	
#BloodClotting	clotting:[]	blood:[]	
#JoeBidenDementia	biden:[]	joe:[]	dementia:[]	
#ChildrenAreAGiftNotLabRats	gift:[]	a:[]	not:[]	are:[]	children:[]	rats:[]	lab:[]	
#MoroccanProtests	protests:[]	moroccan:[]	
#CovidLIARS	a:[]	r:[]	covid:[]	s:[]	i:[]	l:[]	
#WeAreNotAlone	alone:[]	not:[]	are:[]	we:[]	
#StopMaskingKids	masking:[]	stop:[]	kids:[]	
#BestSummerEver	ever:[]	best:[]	summer:[]	
#DoNotComp	comp:[]	not:[]	do:[]	
#OurChildrenOurChoice	children:[]	choice:[]	our:[]	
#BorisMustGoNow	boris:[]	now:[]	go:[]	must:[]	
#StopTheCovidVaxPropaganda	the:[]	covid:[]	stop:[]	propaganda:[]	vax:[]	
#FightforourFreedom	freedom:[]	fightforour:[]	
#MassFormation	mass:[]	formation:[]	
#CancelDougF	cancel:[]	doug:[]	f:[]	
#BioNTech	tech:[]	bio:[]	n:[]	
#CancelNickFerrari	nick:[]	cancel:[]	ferrari:[]	
#MelbourneProtestToday	today:[]	protest:[]	melbourne:[]	
#JenPsaki	jen:[]	psaki:[]	
#NoVaxx	no:[]	vaxx:[]	
#WeSeeYouBoris	see:[]	boris:[]	you:[]	we:[]	
#reinstateBernie	bernie:[]	reinstate:[]	
#OmicronIsAirborne	airborne:[]	omicron:[]	is:[]	
#FreedomRallyLondon	london:[]	freedom:[]	rally:[]	
#CovidVacc	covid:[]	vacc:[]	
#CryptoGems	gems:[]	crypto:[]	
#UKNews	news:[]	u:[]	k:[]	
#PlagueOClaus	claus:[]	plague:[]	o:[]	
#SeattleFirefighters	seattle:[]	firefighters:[]	
#HeartAttacks	attacks:[]	heart:[]	
#TheVaccineIsMoreDeadlyThanTheVirus	deadly:[]	the:[]	vaccine:[]	more:[]	than:[]	is:[]	virus:[]	
#FinancialReset	financial:[]	reset:[]	
#LetsGoHochul	hochul:[]	go:[]	lets:[]	
#NoMoreRestrictions	no:[]	more:[]	restrictions:[]	
#NoJusticeNoPeace	no:[]	peace:[]	justice:[]	
#FarNthQld	nth:[]	far:[]	qld:[]	
#DontDoIt	it:[]	do:[]	dont:[]	
#IrishFreedomDay	freedom:[]	irish:[]	day:[]	
#VacunateYa	ya:[]	vacunate:[]	
#NYCProtests	protests:[]	c:[]	y:[]	n:[]	
#PureEvil	evil:[]	pure:[]	
#ScotlandIsNow	now:[]	is:[]	scotland:[]	
#KidsFirst	first:[]	kids:[]	
#NoVaccinePassportsAnywhere	no:[]	vaccine:[]	passports:[]	anywhere:[]	
#EnglishNews	news:[]	english:[]	
#VaxScam	scam:[]	vax:[]	
#LockStep	lock:[]	step:[]	
#UnitedWeRoar	united:[]	roar:[]	we:[]	
#ioStoConStefanoPuzzer	con:[]	io:[]	puzzer:[]	stefano:[]	sto:[]	
#VoteBlueNoMatterWho	no:[]	blue:[]	matter:[]	vote:[]	who:[]	
#PharmaffiaKilledDemocracy	pharmaffia:[]	killed:[]	democracy:[]	
#MyB	b:[]	my:[]	
#DontCryPRGuy	p:[]	r:[]	guy:[]	cry:[]	dont:[]	
#TuesdayFeeling	tuesday:[]	feeling:[]	
#CovidBooster	covid:[]	booster:[]	
#SackZahawi	sack:[]	zahawi:[]	
#NewWorldOrder	new:[]	world:[]	order:[]	
#BigPhamaOwnsGov	big:[]	phama:[]	owns:[]	gov:[]	
#DontCryPR	p:[]	r:[]	cry:[]	dont:[]	
#GetVaccinatedNow	now:[]	get:[]	vaccinated:[]	
#BorisJohnsonOut	boris:[]	johnson:[]	out:[]	
#NoVaccinePassportsAnywh	no:[]	vaccine:[]	anywh:[]	passports:[]	
#ChairmanDan	dan:[]	chairman:[]	
#TripleThreat	triple:[]	threat:[]	
#ResistAllMandates	all:[]	resist:[]	mandates:[]	
#VaxMandate	mandate:[]	vax:[]	
#StandWithChapmans	with:[]	chapmans:[]	stand:[]	
#ClimateHOAX	a:[]	x:[]	h:[]	climate:[]	o:[]	
#BerlinWall	wall:[]	berlin:[]	
#PaperMasksDontWorkForViruses	viruses:[]	paper:[]	work:[]	for:[]	masks:[]	dont:[]	
#COVIDireland	c:[]	v:[]	i:[]	direland:[]	o:[]	
#NoVaccinePassportsAnywher	no:[]	vaccine:[]	anywher:[]	passports:[]	
#JohnsonMustGo	go:[]	must:[]	johnson:[]	
#ReinstatedBernie	reinstated:[]	bernie:[]	
#HelpUsHelpYou	help:[]	you:[]	us:[]	
#ResistDefyDoNotComply	not:[]	comply:[]	resist:[]	defy:[]	do:[]	
#DenyServices	deny:[]	services:[]	
#EndTyranny	tyranny:[]	end:[]	
#NotMyAustrali	australi:[]	not:[]	my:[]	
#RefuseToComply	comply:[]	refuse:[]	to:[]	
#FreeJulianAssange	assange:[]	julian:[]	free:[]	
#WorldPneumoniaDay	world:[]	pneumonia:[]	day:[]	
#WakeUpUK	wake:[]	u:[]	k:[]	up:[]	
#StandUpNowFreedom	freedom:[]	now:[]	up:[]	stand:[]	
#HappyThanksgiving	happy:[]	thanksgiving:[]	
#WeCanDoThis	can:[]	this:[]	do:[]	we:[]	
#AntiToryLiars	tory:[]	liars:[]	anti:[]	
#CovidUpdates	covid:[]	updates:[]	
#BidensAm	am:[]	bidens:[]	
#TakeOffYourMasks	take:[]	masks:[]	your:[]	off:[]	
#NoDigitalCurrency	digital:[]	no:[]	currency:[]	
#SnpCorruption	snp:[]	corruption:[]	
#RightToExpressDenied	express:[]	to:[]	right:[]	denied:[]	
#UnitedWeStand	united:[]	stand:[]	we:[]	
#BetoForGovernor	beto:[]	for:[]	governor:[]	
#ShameOnYouStephenDonnelly	shame:[]	donnelly:[]	stephen:[]	you:[]	on:[]	
#StandWithFrance	with:[]	france:[]	stand:[]	
#ToryLies	tory:[]	lies:[]	
#QueenElizabeth	elizabeth:[]	queen:[]	
#HeyNext	next:[]	hey:[]	
#SolidarityFor	for:[]	solidarity:[]	
#UpholdRoeVWade	v:[]	uphold:[]	roe:[]	wade:[]	
#ArrestSajidJavid	arrest:[]	sajid:[]	javid:[]	
#NotSafeOrEffective	effective:[]	not:[]	or:[]	safe:[]	
#NotMy	not:[]	my:[]	
#CoerciveContro	contro:[]	coercive:[]	
#NotReassuring	reassuring:[]	not:[]	
#MandatoryVaccination	mandatory:[]	vaccination:[]	
#TestVaxxed	vaxxed:[]	test:[]	
#StopAttackingChildren	stop:[]	children:[]	attacking:[]	
#NoMaskMandate	no:[]	mandate:[]	mask:[]	
#FauciLiedPeopleDied	died:[]	fauci:[]	people:[]	lied:[]	
#WorldPolioDay	world:[]	day:[]	polio:[]	
#VaxXed	xed:[]	vax:[]	
#RecallGavinNewsom	recall:[]	gavin:[]	newsom:[]	
#RejectMandates	reject:[]	mandates:[]	
#VaccinesSaveLives	lives:[]	vaccines:[]	save:[]	
#WhoIsDougBrodie	doug:[]	brodie:[]	is:[]	who:[]	
#BioWeapon	weapon:[]	bio:[]	
#FightForFreedom	freedom:[]	for:[]	fight:[]	
#VoluntaryConsentOnly	only:[]	voluntary:[]	consent:[]	
#ToryCovidDisaster	covid:[]	tory:[]	disaster:[]	
#BlackFriday	black:[]	friday:[]	
#EndTheScamdemic	the:[]	scamdemic:[]	end:[]	
#BidenHarris	biden:[]	harris:[]	
#DeathVaxx	death:[]	vaxx:[]	
#StopVaccinatingChildren	stop:[]	children:[]	vaccinating:[]	
#FreeAustralia	australia:[]	free:[]	
#VoteFordOut	ford:[]	vote:[]	out:[]	
#DataScience	data:[]	science:[]	
#ThisIsO	this:[]	is:[]	o:[]	
#TheirLaughingAtYou	at:[]	their:[]	you:[]	laughing:[]	
#CrimesAgai	agai:[]	crimes:[]	
#SigitalIdentity	sigital:[]	identity:[]	
#CourageToAct	act:[]	to:[]	courage:[]	
#DrLloydFisher	fisher:[]	lloyd:[]	dr:[]	
#HoldThe	the:[]	hold:[]	
#HateSpeech	speech:[]	hate:[]	
#NoVaccineMan	no:[]	vaccine:[]	man:[]	
#KillShot	kill:[]	shot:[]	
#MadeUpVariant	made:[]	variant:[]	up:[]	
#VaccineSideEffectsThere	effects:[]	side:[]	vaccine:[]	there:[]	
#StopTheMandates	the:[]	stop:[]	mandates:[]	
#TheSkyIsFalling	sky:[]	the:[]	falling:[]	is:[]	
#RFKJr	r:[]	f:[]	jr:[]	k:[]	
#ArrestThemAllStartWithFauci	all:[]	with:[]	arrest:[]	start:[]	them:[]	fauci:[]	
#LongCOVID	c:[]	d:[]	v:[]	i:[]	long:[]	o:[]	
#BlackSwan	swan:[]	black:[]	
#VoteScience	science:[]	vote:[]	
#AlexJonesShow	alex:[]	show:[]	jones:[]	
#BidenAdministrations	biden:[]	administrations:[]	
#TimeToTakeAStand	a:[]	take:[]	to:[]	time:[]	stand:[]	
#VaccinationIsNotCompulsory	compulsory:[]	not:[]	is:[]	vaccination:[]	
#ScienceSaturday	saturday:[]	science:[]	
#freeAustralia	australia:[]	free:[]	
#FoxandFr	foxand:[]	fr:[]	
#BadNurses	bad:[]	nurses:[]	
#AxeTheVax	the:[]	vax:[]	axe:[]	
#SupremeCourt	supreme:[]	court:[]	
#TheMaskofTheBeast	the:[]	beast:[]	maskof:[]	
#NoAlPaseSanitario	no:[]	pase:[]	sanitario:[]	al:[]	
#VaccinatieSchade	vaccinatie:[]	schade:[]	
#NoToCoercion	no:[]	coercion:[]	to:[]	
#SajidJavid	sajid:[]	javid:[]	
#COVIDVic	vic:[]	c:[]	d:[]	v:[]	i:[]	o:[]	
#NotoVaccineMandates	vaccine:[]	mandates:[]	noto:[]	
#NaziAustralia	nazi:[]	australia:[]	
#VaccineNOTvaccine	vaccine:[]	tvaccine:[]	n:[]	o:[]	
#LockdownFuerUngeimpfte	lockdown:[]	ungeimpfte:[]	fuer:[]	
#EndThisNow	now:[]	this:[]	end:[]	
#ToryCriminalsUnfitToGovern	tory:[]	govern:[]	criminals:[]	to:[]	unfit:[]	
#MassProtests	protests:[]	mass:[]	
#DefundVaxMandates	defund:[]	mandates:[]	vax:[]	
#CanYaSeeMeNow	can:[]	see:[]	now:[]	me:[]	ya:[]	
#TrudeauCorruption	trudeau:[]	corruption:[]	
#SiljaPaavola	paavola:[]	silja:[]	
#CyberPolygon	cyber:[]	polygon:[]	
#RomeProtests	rome:[]	protests:[]	
#NeverGiveUp	give:[]	never:[]	up:[]	
#GasChambers	chambers:[]	gas:[]	
#ReligiousExemption	religious:[]	exemption:[]	
#NoForcedVaccin	vaccin:[]	no:[]	forced:[]	
#mRNAVaccines	a:[]	r:[]	vaccines:[]	m:[]	n:[]	
#LoveYourNeighbor	love:[]	your:[]	neighbor:[]	
#VforVendetta	vendetta:[]	vfor:[]	
#OrganizedCr	organized:[]	cr:[]	
#CovidWasAnInsideJo	covid:[]	jo:[]	was:[]	inside:[]	an:[]	
#ItsOver	over:[]	its:[]	
#NoToBoosters	no:[]	boosters:[]	to:[]	
#BillDeBlasio	de:[]	blasio:[]	bill:[]	
#SleepyJoe	joe:[]	sleepy:[]	
#PfizerLiedPeopleDied	pfizer:[]	died:[]	people:[]	lied:[]	
#SocialismoEsM	m:[]	es:[]	socialismo:[]	
#CovidVaccineinj	covid:[]	vaccineinj:[]	
#PopulationControl	control:[]	population:[]	
#ChapmansIceCream	chapmans:[]	cream:[]	ice:[]	
#StopCoercion	stop:[]	coercion:[]	
#FauciLied	fauci:[]	lied:[]	
#NphetMustGo	nphet:[]	go:[]	must:[]	
#IDoNotComply	not:[]	comply:[]	i:[]	do:[]	
#CovidVaxx	covid:[]	vaxx:[]	
#BlackTwittermovement	twittermovement:[]	black:[]	
#NoVacvinePassportAnywhere	no:[]	passport:[]	anywhere:[]	vacvine:[]	
#CrookedPolitician	politician:[]	crooked:[]	
#LeaveThoseKidsAlone	alone:[]	leave:[]	those:[]	kids:[]	
#AixEnProvence	aix:[]	provence:[]	en:[]	
#UbVaccinated	vaccinated:[]	ub:[]	
#ResistTyranny	tyranny:[]	resist:[]	
#SanFranciscos	san:[]	franciscos:[]	
#NoMoreLockdowns	lockdowns:[]	no:[]	more:[]	
#GreatResist	resist:[]	great:[]	
#NoMadates	no:[]	madates:[]	
#StephenDonneLly	stephen:[]	lly:[]	donne:[]	
#WatchDog	watch:[]	dog:[]	
#CEOs	c:[]	os:[]	e:[]	
#FreePress	press:[]	free:[]	
#GabrielPizza	pizza:[]	gabriel:[]	
#ListenToExperts	to:[]	experts:[]	listen:[]	
#VaxMandat	mandat:[]	vax:[]	
#covidHoax	covid:[]	hoax:[]	
#CovidIsReal	covid:[]	is:[]	real:[]	
#AustraliaHasNOTFallen	fallen:[]	t:[]	australia:[]	has:[]	n:[]	o:[]	
#BOYCOTTChapmans	chapmans:[]	b:[]	c:[]	t:[]	y:[]	o:[]	
#EvilFDA	a:[]	d:[]	f:[]	evil:[]	
#FunVax	vax:[]	fun:[]	
#CharminUltraSoft	charmin:[]	soft:[]	ultra:[]	
#ThisMorning	this:[]	morning:[]	
#PandemicOfTheVaccinated	the:[]	of:[]	vaccinated:[]	pandemic:[]	
#SpanishFlu	spanish:[]	flu:[]	
#TheI	the:[]	i:[]	
#DefundMedia	defund:[]	media:[]	
#SatanIsShowing	satan:[]	is:[]	showing:[]	
#ElectionBreaking	election:[]	breaking:[]	
#TakeOffYourMask	take:[]	your:[]	off:[]	mask:[]	
#FkTonyFauci	tony:[]	fk:[]	fauci:[]	
#NoCovidPass	no:[]	covid:[]	pass:[]	
#VariantsofConcern	variantsof:[]	concern:[]	
#ElectionsResult	result:[]	elections:[]	
#BeatChina	china:[]	beat:[]	
#GetYourBoosterShot	get:[]	your:[]	booster:[]	shot:[]	
#TrickOrTreat	treat:[]	or:[]	trick:[]	
#TheU	the:[]	u:[]	
#GetVaccinated	get:[]	vaccinated:[]	
#FreeHumanity	free:[]	humanity:[]	
#NoMandat	no:[]	mandat:[]	
#NoVaccinePasspo	no:[]	vaccine:[]	passpo:[]	
#NicholasSeppy	seppy:[]	nicholas:[]	
#SomyurekTheBill	the:[]	somyurek:[]	bill:[]	
#WednesdayMotivation	motivation:[]	wednesday:[]	
#BonnieHenry	henry:[]	bonnie:[]	
#ConservativeBigBlueTent	tent:[]	big:[]	conservative:[]	blue:[]	
#PodcastBanter	banter:[]	podcast:[]	
#HoldTheL	the:[]	l:[]	hold:[]	
#MedicalApartide	medical:[]	apartide:[]	
#CrimeMinister	minister:[]	crime:[]	
#DigitalTransformation	digital:[]	transformation:[]	
#RadioGenova	genova:[]	radio:[]	
#InNOut	in:[]	n:[]	out:[]	
#ImWithBigBird	big:[]	with:[]	im:[]	bird:[]	
#NoMoreLockdo	lockdo:[]	no:[]	more:[]	
#BlackTwitter	twitter:[]	black:[]	
#VaccineClinic	vaccine:[]	clinic:[]	
#VaccineNOT	vaccine:[]	t:[]	n:[]	o:[]	
#CdnPoli	poli:[]	cdn:[]	
#PoliceState	police:[]	state:[]	
#PandemicInTheRearViewMirror	the:[]	rear:[]	mirror:[]	view:[]	in:[]	pandemic:[]	
#disbandNPHET	p:[]	t:[]	e:[]	h:[]	disband:[]	n:[]	
#GOPer	g:[]	per:[]	o:[]	
#GlobalNazis	global:[]	nazis:[]	
#GRomeSummit	rome:[]	g:[]	summit:[]	
#MedinaSpirit	spirit:[]	medina:[]	
#VirusScam	scam:[]	virus:[]	
#ToPROTECTandSERVE	p:[]	r:[]	s:[]	c:[]	t:[]	tand:[]	e:[]	v:[]	to:[]	o:[]	
#SaveTheKids	the:[]	save:[]	kids:[]	
#UrsulaVonDerLeyen	der:[]	von:[]	ursula:[]	leyen:[]	
#DoYouSeeItYet	see:[]	yet:[]	it:[]	do:[]	you:[]	
#LockDown	lock:[]	down:[]	
#LeaveOu	ou:[]	leave:[]	
#SiamoTuttiPortuali	tutti:[]	portuali:[]	siamo:[]	
#SpyGate	gate:[]	spy:[]	
#BraunauamInn	inn:[]	braunauam:[]	
#NonAuPasse	au:[]	passe:[]	non:[]	
#MAGAlubed	a:[]	g:[]	alubed:[]	m:[]	
#SackPatKenny	pat:[]	sack:[]	kenny:[]	
#JamTheAirports	the:[]	jam:[]	airports:[]	
#ClapForTheNHS	the:[]	s:[]	clap:[]	h:[]	for:[]	n:[]	
#NoVaccineSanctions	no:[]	vaccine:[]	sanctions:[]	
#FauciHumanExperimentation	experimentation:[]	fauci:[]	human:[]	
#StandInThePark	the:[]	in:[]	stand:[]	park:[]	
#JailPfizer	pfizer:[]	jail:[]	
#ScottishIndependence	independence:[]	scottish:[]	
#UrsulavonderLeyens	ursulavonder:[]	leyens:[]	
#LeiMun	lei:[]	mun:[]	
#GetVacci	vacci:[]	get:[]	
#NoTwoTierSociety	no:[]	society:[]	tier:[]	two:[]	
#NoMoreSnakeOil	no:[]	oil:[]	more:[]	snake:[]	
#SleepingGiant	giant:[]	sleeping:[]	
#ShameOnYou	shame:[]	you:[]	on:[]	
#RomeGSummit	rome:[]	g:[]	summit:[]	
#FreeSpeechMatters	matters:[]	speech:[]	free:[]	
#NoV	no:[]	v:[]	
#FlatEarth	flat:[]	earth:[]	
#ToryCovidCatastrophe	covid:[]	tory:[]	catastrophe:[]	
#GlobalElites	global:[]	elites:[]	
#MommaBear	bear:[]	momma:[]	
#FraudVaccine	vaccine:[]	fraud:[]	
#NoG	no:[]	g:[]	
#EndTyrannyNOW	tyranny:[]	w:[]	end:[]	n:[]	o:[]	
#FreeThemAll	all:[]	them:[]	free:[]	
#NoM	no:[]	m:[]	
#GrapheneOxide	oxide:[]	graphene:[]	
#RiseMebourne	mebourne:[]	rise:[]	
#ProsecuteJacinda	jacinda:[]	prosecute:[]	
#DidYouGetYourBooster	get:[]	your:[]	booster:[]	you:[]	did:[]	
#SatanicCult	cult:[]	satanic:[]	
#HealthcareHeroes	heroes:[]	healthcare:[]	
#NaziMasks	nazi:[]	masks:[]	
#GoBrandon	brandon:[]	go:[]	
#ThisIsNotANegotiation	a:[]	not:[]	negotiation:[]	this:[]	is:[]	
#MakeCatNapTimeMandatory	cat:[]	time:[]	nap:[]	mandatory:[]	make:[]	
#TrustGod	trust:[]	god:[]	
#FreshVoicesRise	voices:[]	rise:[]	fresh:[]	
#PassDeL	de:[]	pass:[]	l:[]	
#DoNotObey	not:[]	obey:[]	do:[]	
#MillionsMarch	millions:[]	march:[]	
#WorldLeadersSilent	silent:[]	world:[]	leaders:[]	
#BuildBackBroke	broke:[]	build:[]	back:[]	
#ImmuneSystem	system:[]	immune:[]	
#NonA	a:[]	non:[]	
#GetYourCovidBooster	covid:[]	get:[]	your:[]	booster:[]	
#PublicHealthEngland	england:[]	public:[]	health:[]	
#MelbourneProtests	protests:[]	melbourne:[]	
#mRNAvaccines	r:[]	avaccines:[]	m:[]	n:[]	
#ConspiracyTheory	conspiracy:[]	theory:[]	
#MakeHealthPrimary	health:[]	make:[]	primary:[]	
#BoostersAreFree	are:[]	boosters:[]	free:[]	
#WokeFascism	woke:[]	fascism:[]	
#NoNaziPass	nazi:[]	no:[]	pass:[]	
#NeverGiveUP	p:[]	give:[]	never:[]	u:[]	
#SaveTheBabyHumans	the:[]	baby:[]	save:[]	humans:[]	
#FuckOffBoris	boris:[]	fuck:[]	off:[]	
#BenGarrison	garrison:[]	ben:[]	
#NoLockdowns	lockdowns:[]	no:[]	
#FuckJoeBiden	biden:[]	joe:[]	fuck:[]	
#NotothePassofSHAME	a:[]	s:[]	passof:[]	e:[]	h:[]	notothe:[]	m:[]	
#ThinkForYourself	think:[]	for:[]	yourself:[]	
#EpsteinIsland	epstein:[]	island:[]	
#FraudAlert	alert:[]	fraud:[]	
#NonAuPassSani	au:[]	pass:[]	sani:[]	non:[]	
#HotMic	mic:[]	hot:[]	
#resignKieranMoore	moore:[]	kieran:[]	resign:[]	
#WakeUp	wake:[]	up:[]	
#noGREENpass	no:[]	r:[]	e:[]	g:[]	npass:[]	
#SackAdrianCummins	sack:[]	adrian:[]	cummins:[]	
#wakeupScotland	wakeup:[]	scotland:[]	
#AmericasFrontlineDoctors	frontline:[]	doctors:[]	americas:[]	
#WeR	r:[]	we:[]	
#WeW	w:[]	we:[]	
#CivilLiberties	liberties:[]	civil:[]	
#JustSayNoToBigBird	big:[]	no:[]	bird:[]	say:[]	to:[]	just:[]	
#WearAM	a:[]	wear:[]	m:[]	
#letsgoBrandon	letsgo:[]	brandon:[]	
#GisingPilipinas	gising:[]	pilipinas:[]	
#DenverPD	p:[]	denver:[]	d:[]	
#ShakespeareSunday	sunday:[]	shakespeare:[]	
#NoTotal	no:[]	total:[]	
#PersonalResponsibility	responsibility:[]	personal:[]	
#DoNot	not:[]	do:[]	
#VFMario	f:[]	v:[]	mario:[]	
#ToryDictators	tory:[]	dictators:[]	
#VaccineDodger	vaccine:[]	dodger:[]	
#VoteForLiberty	liberty:[]	for:[]	vote:[]	
#SackedCarers	sacked:[]	carers:[]	
#WorldwideFreedomRally	freedom:[]	worldwide:[]	rally:[]	
#VaccinateOurKids	vaccinate:[]	our:[]	kids:[]	
#FollowSafetyProtocols	safety:[]	protocols:[]	follow:[]	
#AussieRevolution	aussie:[]	revolution:[]	
#NoMore	no:[]	more:[]	
#TheGreatResignation	the:[]	resignation:[]	great:[]	
#RefuseTheGre	the:[]	refuse:[]	gre:[]	
#GameFi	game:[]	fi:[]	
#DontComply	comply:[]	dont:[]	
#WTLiteralF	t:[]	f:[]	w:[]	literal:[]	
#NorthCarolina	carolina:[]	north:[]	
#NaziGermany	nazi:[]	germany:[]	
#GreenPass	green:[]	pass:[]	
#InformedConsent	informed:[]	consent:[]	
#PatriotsUnite	unite:[]	patriots:[]	
#NoVaxMandates	no:[]	mandates:[]	vax:[]	
#MandateThis	mandate:[]	this:[]	
#FightBack	back:[]	fight:[]	
#UKGovernment	government:[]	u:[]	k:[]	
#HealthAndCareBill	and:[]	bill:[]	health:[]	care:[]	
#NoMasksAnywhere	no:[]	masks:[]	anywhere:[]	
#CivilDisobedienceNow	disobedience:[]	now:[]	civil:[]	
#SanDiego	san:[]	diego:[]	
#WeAreMany	are:[]	many:[]	we:[]	
#UnitedweStand	unitedwe:[]	stand:[]	
#RapistsRepent	repent:[]	rapists:[]	
#NationalShutdown	national:[]	shutdown:[]	
#BoycottAustralianOpen	australian:[]	boycott:[]	open:[]	
#NoMandato	no:[]	mandato:[]	
#StandFree	free:[]	stand:[]	
#TheMillion	the:[]	million:[]	
#MedicalFreedom	medical:[]	freedom:[]	
#VaccineBreakthrough	vaccine:[]	breakthrough:[]	
#WindsorPark	windsor:[]	park:[]	
#SayNoToJab	no:[]	jab:[]	say:[]	to:[]	
#UnmaskOurChildren	children:[]	our:[]	unmask:[]	
#FearPorn	porn:[]	fear:[]	
#TheGreatGlo	the:[]	glo:[]	great:[]	
#LockdownLockout	lockout:[]	lockdown:[]	
#NoCertificado	no:[]	certificado:[]	
#WorldWide	world:[]	wide:[]	
#ReclaimThe	the:[]	reclaim:[]	
#CancelTheLockdown	the:[]	cancel:[]	lockdown:[]	
#HeikoKhoo	heiko:[]	khoo:[]	
#DemocratsAreFascists	fascists:[]	are:[]	democrats:[]	
#ClimateHoax	climate:[]	hoax:[]	
#IdentityV	v:[]	identity:[]	
#IStandWithItaly	with:[]	i:[]	stand:[]	italy:[]	
#NoGreenPassObbligatorio	no:[]	green:[]	pass:[]	obbligatorio:[]	
#CovidVAXBullies	a:[]	covid:[]	v:[]	x:[]	bullies:[]	
#VaccinationControlGroup	control:[]	group:[]	vaccination:[]	
#StopTheMandate	the:[]	mandate:[]	stop:[]	
#LetsGoDrakeford	go:[]	lets:[]	drakeford:[]	
#JoJoDodo	jo:[]	dodo:[]	
#LetDownLeft	left:[]	let:[]	down:[]	
#TrudeauCrimeFamily	trudeau:[]	crime:[]	family:[]	
#SayNoToMandates	no:[]	say:[]	mandates:[]	to:[]	
#IwillNotComply	not:[]	comply:[]	iwill:[]	
#RealNotRare	not:[]	rare:[]	real:[]	
#ThursdayThoughts	thoughts:[]	thursday:[]	
#NotGuilty	not:[]	guilty:[]	
#PrinceAndrew	andrew:[]	prince:[]	
#AfricaUnite	africa:[]	unite:[]	
#YourTimeIsUp	is:[]	up:[]	time:[]	your:[]	
#BidensIllegalVaccineMandate	mandate:[]	vaccine:[]	bidens:[]	illegal:[]	
#AbolishTheCDC	the:[]	c:[]	d:[]	abolish:[]	
#VaccineSideEffect	side:[]	vaccine:[]	effect:[]	
#LeaveOurKidsAlone	alone:[]	leave:[]	our:[]	kids:[]	
#TheLight	the:[]	light:[]	
#NotTheFlu	the:[]	not:[]	flu:[]	
#VelvetRevolution	velvet:[]	revolution:[]	
#ClimateChage	chage:[]	climate:[]	
#UKParliament	u:[]	k:[]	parliament:[]	
#NoNewNorm	new:[]	no:[]	norm:[]	
#ReformUK	reform:[]	u:[]	k:[]	
#boycottTesco	tesco:[]	boycott:[]	
#YoungPatriots	young:[]	patriots:[]	
#ImWithKylieight	with:[]	kylieight:[]	im:[]	
#BoycottBiasedMedia	biased:[]	media:[]	boycott:[]	
#DougBrodieForPM	p:[]	doug:[]	brodie:[]	for:[]	m:[]	
#NoNutNovemberChallenge	november:[]	no:[]	challenge:[]	nut:[]	
#RIPAustria	p:[]	r:[]	i:[]	austria:[]	
#VaxFlop	flop:[]	vax:[]	
#FullyVaccinated	vaccinated:[]	fully:[]	
#JustSay	say:[]	just:[]	
#BigGovt	big:[]	govt:[]	
#UsforThemUK	u:[]	them:[]	k:[]	usfor:[]	
#WorldWiseWalkout	wise:[]	world:[]	walkout:[]	
#OmiCON	c:[]	omi:[]	n:[]	o:[]	
#BigPharmaScam	big:[]	scam:[]	pharma:[]	
#GettingMyBooster	getting:[]	my:[]	booster:[]	
#VernonColeman	coleman:[]	vernon:[]	
#ResignJacinda	jacinda:[]	resign:[]	
#GetTheBooster	the:[]	get:[]	booster:[]	
#RTECovidLIARS	a:[]	covid:[]	r:[]	s:[]	t:[]	e:[]	i:[]	l:[]	
#NoMedicalApar	no:[]	medical:[]	apar:[]	
##DanGone	dan:[]	gone:[]	
#SkyFall	sky:[]	fall:[]	
#StandupSpeak	standup:[]	speak:[]	
#CovidBullies	covid:[]	bullies:[]	
#NoVaccineMandates#	no:[]	vaccine:[]	mandates:[]	
#CovidIsOver	over:[]	covid:[]	is:[]	
#GasPriceHike	price:[]	gas:[]	hike:[]	
#TruthBOMB	b:[]	truth:[]	m:[]	o:[]	
#SundayThought	sunday:[]	thought:[]	
#DiabolicalPlan	diabolical:[]	plan:[]	
#TelegraphScamdemic	telegraph:[]	scamdemic:[]	
#COPGlasgo	p:[]	c:[]	glasgo:[]	o:[]	
#COVIDisAirborne	airborne:[]	c:[]	v:[]	i:[]	dis:[]	o:[]	
#COVIDnsw	dnsw:[]	c:[]	v:[]	i:[]	o:[]	
#InjectCriticalThinking	critical:[]	thinking:[]	inject:[]	
#VaccineEfficacy	vaccine:[]	efficacy:[]	
#OmicronVarientvery	omicron:[]	varientvery:[]	
#NoVacc	no:[]	vacc:[]	
#NoVaccinePassportAnywhe	no:[]	vaccine:[]	anywhe:[]	passport:[]	
#VaxHarm	harm:[]	vax:[]	
#CovidPaSS	pa:[]	covid:[]	s:[]	
#IWillNotComply	not:[]	comply:[]	will:[]	i:[]	
#StopVaccineMandates	vaccine:[]	stop:[]	mandates:[]	
#WakeUpSheeple	wake:[]	sheeple:[]	up:[]	
#StopGettingTeste	getting:[]	teste:[]	stop:[]	
#VaccinVirus	vaccin:[]	virus:[]	
#letsgoBranden	letsgo:[]	branden:[]	
#NoToPlanB	no:[]	b:[]	to:[]	plan:[]	
#BackToNormal	normal:[]	back:[]	to:[]	
#BorisJohnsonHates	boris:[]	johnson:[]	hates:[]	
#FrenchResistance	resistance:[]	french:[]	
#UsefulIdiots	useful:[]	idiots:[]	
#CCPChina	p:[]	c:[]	china:[]	
#UsForTheUK	the:[]	u:[]	for:[]	k:[]	us:[]	
#NoScrubs	scrubs:[]	no:[]	
#CardiffProtest	protest:[]	cardiff:[]	
#DoNotForceForVaccine	vaccine:[]	not:[]	for:[]	force:[]	do:[]	
#MSMliars	s:[]	mliars:[]	m:[]	
#PlayStupidGames	play:[]	stupid:[]	games:[]	
#DestroyTheTories	the:[]	tories:[]	destroy:[]	
#WipedFromInternet	wiped:[]	from:[]	internet:[]	
#AreYouBrightEnough	are:[]	bright:[]	enough:[]	you:[]	
#NoGreenPassObbliga	obbliga:[]	no:[]	green:[]	pass:[]	
#KidsNeedFreshAirNotShots	not:[]	need:[]	air:[]	shots:[]	fresh:[]	kids:[]	
#TheHague	the:[]	hague:[]	
#GlennBeck	beck:[]	glenn:[]	
#IrishMediaScum	irish:[]	media:[]	scum:[]	
#DisbandNPHET	p:[]	t:[]	e:[]	h:[]	disband:[]	n:[]	
#TogetherDeclaratio	declaratio:[]	together:[]	
#DavosAgenda	davos:[]	agenda:[]	
#virtueSignallers	signallers:[]	virtue:[]	
#ThisIsOurSh	sh:[]	this:[]	is:[]	our:[]	
#StopGlobalChildAbuse	abuse:[]	stop:[]	global:[]	child:[]	
#SpiderManNoWayHome	no:[]	man:[]	spider:[]	way:[]	home:[]	
#PersonalChoice	personal:[]	choice:[]	
#NHSJobs	s:[]	jobs:[]	h:[]	n:[]	
#NurembergTrials	trials:[]	nuremberg:[]	
#thNovember	november:[]	th:[]	
#GainOfFunction	function:[]	of:[]	gain:[]	
#NoGreenPassObligato	no:[]	green:[]	pass:[]	obligato:[]	
#NationalGuard	guard:[]	national:[]	
#CatherineAustinFitts	austin:[]	catherine:[]	fitts:[]	
#DiabetesHeres	heres:[]	diabetes:[]	
#ResistTyrannyNow	tyranny:[]	now:[]	resist:[]	
#TalkLiberation	liberation:[]	talk:[]	
#JeremyVineon	jeremy:[]	vineon:[]	
#CovidVaccination	covid:[]	vaccination:[]	
#GlobalistTyrant	globalist:[]	tyrant:[]	
#CovidVaxExposed	covid:[]	exposed:[]	vax:[]	
#VaxPimp	pimp:[]	vax:[]	
#DoNotcomply	notcomply:[]	do:[]	
#NoVaccinesForKids	no:[]	vaccines:[]	for:[]	kids:[]	
#FIFAMobile	a:[]	f:[]	mobile:[]	i:[]	
#NoVaccineMand	no:[]	vaccine:[]	mand:[]	
#ScrapTheAct	the:[]	scrap:[]	act:[]	
#SpecialSession	special:[]	session:[]	
#KyleRittenhouse	kyle:[]	rittenhouse:[]	
#GeertVandenBossche	geert:[]	bossche:[]	vanden:[]	
#TrudeauMustGo	trudeau:[]	go:[]	must:[]	
#GeenQR	q:[]	r:[]	geen:[]	
#CovidHoaxDictatorship	covid:[]	dictatorship:[]	hoax:[]	
#EndTheLockdown	the:[]	lockdown:[]	end:[]	
#PeaceRiverNorth	north:[]	peace:[]	river:[]	
#MaskItOrCasket	or:[]	casket:[]	it:[]	mask:[]	
#CrimesAgainstChildren	children:[]	against:[]	crimes:[]	
#SundayMotivation	sunday:[]	motivation:[]	
#GetVaccinate	vaccinate:[]	get:[]	
#AussieNazisForceVaccinate	vaccinate:[]	force:[]	aussie:[]	nazis:[]	
#CocainePsychosis	cocaine:[]	psychosis:[]	
#FingerBill	finger:[]	bill:[]	
#VanHelsing	van:[]	helsing:[]	
#NoJab	no:[]	jab:[]	
#NoMandatory	no:[]	mandatory:[]	
#novemberDenHaag	november:[]	den:[]	haag:[]	
#CoronaInfoCH	c:[]	h:[]	corona:[]	info:[]	
#LiberalSpring	spring:[]	liberal:[]	
#VaccineDeath	vaccine:[]	death:[]	
#IStandWithDorisGrinspun	with:[]	doris:[]	grinspun:[]	i:[]	stand:[]	
#BigTech	tech:[]	big:[]	
#VaccinationObligatoire	obligatoire:[]	vaccination:[]	
#JailDanAndrews	dan:[]	jail:[]	andrews:[]	
#FreeDonziger	donziger:[]	free:[]	
#ToriesUnfitToGovern	tories:[]	govern:[]	to:[]	unfit:[]	
#AntiFascist	fascist:[]	anti:[]	
#DomsNext	next:[]	doms:[]	
#TrumpWon	trump:[]	won:[]	
#CovidIreland	covid:[]	ireland:[]	
#NewNazis	new:[]	nazis:[]	
#VaccineBuddy	vaccine:[]	buddy:[]	
#PutSouthAfricaFirst	africa:[]	south:[]	first:[]	put:[]	
#SouthAustralia	south:[]	australia:[]	
#ClimateEmergenc	emergenc:[]	climate:[]	
#BlockchainGaming	gaming:[]	blockchain:[]	
#BritishColumbia	columbia:[]	british:[]	
#MedicalAparthei	medical:[]	aparthei:[]	
#FolloMe	follo:[]	me:[]	
#VaccineAgenda	vaccine:[]	agenda:[]	
#CelineDion	celine:[]	dion:[]	
#TheGr	the:[]	gr:[]	
#PassofSHAME	a:[]	s:[]	passof:[]	e:[]	h:[]	m:[]	
#AuspolSoCorrupt	auspol:[]	corrupt:[]	so:[]	
#TruthSocial	truth:[]	social:[]	
#portualidiTrieste	trieste:[]	portualidi:[]	
#FlawedData	data:[]	flawed:[]	
#PuertoRico	puerto:[]	rico:[]	
#CoronaVirus	virus:[]	corona:[]	
#IconoclastRoundtable	iconoclast:[]	roundtable:[]	
#FluVaccine	vaccine:[]	flu:[]	
#EndTheTyranny	the:[]	tyranny:[]	end:[]	
#NowListening	listening:[]	now:[]	
#VaccinesSavesLives	lives:[]	saves:[]	vaccines:[]	
#RPSMTrust	trust:[]	p:[]	r:[]	s:[]	m:[]	
#MichaelGunner	michael:[]	gunner:[]	
#TestTheVaccinated	the:[]	test:[]	vaccinated:[]	
#SouthwestAirlines	southwest:[]	airlines:[]	
#ChicagoIL	i:[]	l:[]	chicago:[]	
#RevolutionWillNotBeTelevised	not:[]	be:[]	will:[]	televised:[]	revolution:[]	
#ZincIonophore	ionophore:[]	zinc:[]	
#CovidCanada	covid:[]	canada:[]	
#LondonOntario	london:[]	ontario:[]	
#MonicaSmit	smit:[]	monica:[]	
#FinancialCrash	financial:[]	crash:[]	
#NoToDiscrimination	no:[]	discrimination:[]	to:[]	
#ArrestDanAndrews	dan:[]	arrest:[]	andrews:[]	
#MedicalTyranny	medical:[]	tyranny:[]	
#GlobalistTraitors	traitors:[]	globalist:[]	
#NoVaccineShots	no:[]	vaccine:[]	shots:[]	
#wewillALLbethere	a:[]	wewill:[]	lbethere:[]	l:[]	
#BlindJoe	joe:[]	blind:[]	
#NebraskaZoo	nebraska:[]	zoo:[]	
#NonAuPasseportSanitaire	au:[]	passeport:[]	sanitaire:[]	non:[]	
#Tyranny#NewZealand	new:[]	tyranny:[]	zealand:[]	
#BadPharma	bad:[]	pharma:[]	
#ChrisDirtroad	dirtroad:[]	chris:[]	
#ChicagoPD	p:[]	d:[]	chicago:[]	
#AbsoluteRiskReduction	absolute:[]	risk:[]	reduction:[]	
#stephenDonnelly	donnelly:[]	stephen:[]	
#ReinstateDarren	darren:[]	reinstate:[]	
#TaxExtortion	tax:[]	extortion:[]	
#NoMandatoryVac	no:[]	vac:[]	mandatory:[]	
#ThisIsTheir	this:[]	their:[]	is:[]	
#DayHorrorChallenge	horror:[]	challenge:[]	day:[]	
#DontWaitVaccinate	vaccinate:[]	wait:[]	dont:[]	
#DivideAndRule	and:[]	rule:[]	divide:[]	
#FreedomRally	freedom:[]	rally:[]	
#MedicalMafia	medical:[]	mafia:[]	
#BetaMale	male:[]	beta:[]	
#AdverseEvent	event:[]	adverse:[]	
#ItsJustafewWeeks	justafew:[]	weeks:[]	its:[]	
#GlobalWarrning	warrning:[]	global:[]	
#VaccineEconimics	vaccine:[]	econimics:[]	
#CovidCuckoo	covid:[]	cuckoo:[]	
#COVIDvaccination	c:[]	v:[]	i:[]	dvaccination:[]	o:[]	
#HelpOthersGetVaccinatedGetYourChildrenVaccinated	help:[]	children:[]	get:[]	your:[]	vaccinated:[]	others:[]	
#CovidNaziPass	nazi:[]	covid:[]	pass:[]	
#NFTs	f:[]	n:[]	ts:[]	
#MalieVeld	veld:[]	malie:[]	
#YourCall	call:[]	your:[]	
#TeleChannels	channels:[]	tele:[]	
#MasksAreMoronic	moronic:[]	are:[]	masks:[]	
#WuFlu	flu:[]	wu:[]	
#SadLittleMan	sad:[]	man:[]	little:[]	
#ThisHi	hi:[]	this:[]	
#FakeV	v:[]	fake:[]	
#DrPeterRidd	ridd:[]	peter:[]	dr:[]	
#IvanVilibor	vilibor:[]	ivan:[]	
#FiannaFil	fianna:[]	fil:[]	
#SayNoToVaccineMandates	no:[]	vaccine:[]	say:[]	mandates:[]	to:[]	
#AlexJonesWasRight	alex:[]	was:[]	right:[]	jones:[]	
#ChrisSky	sky:[]	chris:[]	
#VaccineForAll	all:[]	vaccine:[]	for:[]	
#HandsOffOurKikds	hands:[]	kikds:[]	our:[]	off:[]	
#IfYouKnowYouKnow	know:[]	if:[]	you:[]	
#KlausSchwab	schwab:[]	klaus:[]	
#TrustFauci	trust:[]	fauci:[]	
#TheBrandonAdministration	the:[]	brandon:[]	administration:[]	
#VaccineSideEffects	effects:[]	side:[]	vaccine:[]	
#ResistTheMandate	the:[]	mandate:[]	resist:[]	
#BeFearless	be:[]	fearless:[]	
#RealNews	news:[]	real:[]	
#DemVoice	voice:[]	dem:[]	
#MarioDraghi	mario:[]	draghi:[]	
#BoycottTesco	tesco:[]	boycott:[]	
#NaziLand	nazi:[]	land:[]	
#MainstreamMedia	mainstream:[]	media:[]	
#LetsGoBrandonDay	brandon:[]	go:[]	lets:[]	day:[]	
#IvermectinSavesLives	lives:[]	saves:[]	ivermectin:[]	
#TheGrea	the:[]	grea:[]	
#EMASisonke	a:[]	sisonke:[]	e:[]	m:[]	
#VoteSliwa	sliwa:[]	vote:[]	
#ArrestFaucci	faucci:[]	arrest:[]	
#MedTwitter	twitter:[]	med:[]	
#FreedomFest	freedom:[]	fest:[]	
#NonAuPassDeLaH	de:[]	au:[]	la:[]	pass:[]	h:[]	non:[]	
#LetsGoBranDan	dan:[]	bran:[]	go:[]	lets:[]	
#LetsGoBrian	go:[]	lets:[]	brian:[]	
#HerdImmunity	immunity:[]	herd:[]	
#BeagleGate	beagle:[]	gate:[]	
#FascistVaccinePassport	vaccine:[]	passport:[]	fascist:[]	
#IVaxProtect	i:[]	protect:[]	vax:[]	
#AdarPoonawalla	adar:[]	poonawalla:[]	
#DeathSantis	death:[]	santis:[]	
#SchoolChoice	school:[]	choice:[]	
#UnitedStates	united:[]	states:[]	
#UtGov	gov:[]	ut:[]	
#PeoplePower	power:[]	people:[]	
#GovernmentCorruption	government:[]	corruption:[]	
#FormerGuy	guy:[]	former:[]	
#UnitedWeS	s:[]	united:[]	we:[]	
#YellowCardDemo	yellow:[]	demo:[]	card:[]	
#NoMoreLo	no:[]	lo:[]	more:[]	
#GetABoostedBaby	a:[]	get:[]	baby:[]	boosted:[]	
#SackChrisWhitty	chris:[]	sack:[]	whitty:[]	
#NoVaccineManda	no:[]	vaccine:[]	manda:[]	
#VaccinesKill	vaccines:[]	kill:[]	
#DdimerTest	test:[]	ddimer:[]	
#CovidPSYCHOS	p:[]	covid:[]	c:[]	s:[]	h:[]	y:[]	o:[]	
#NicolaSturgeon	nicola:[]	sturgeon:[]	
#ExpandtheSupremeCourt	supreme:[]	court:[]	expandthe:[]	
#MattGaetz	matt:[]	gaetz:[]	
#WarRoom	war:[]	room:[]	
#TogetherWeAreUnstopp	are:[]	unstopp:[]	we:[]	together:[]	
#AustriaFascistState	state:[]	fascist:[]	austria:[]	
#VaxxEmancipationProclimation	emancipation:[]	proclimation:[]	vaxx:[]	
#ThisEndsNow	now:[]	ends:[]	this:[]	
#SaveLives	lives:[]	save:[]	
#ReasonableForce	reasonable:[]	force:[]	
#CovidBeGone	covid:[]	be:[]	gone:[]	
#ToKeepYouSafe	keep:[]	safe:[]	to:[]	you:[]	
#MSMliar	s:[]	mliar:[]	m:[]	
#BurnTheMask	the:[]	burn:[]	mask:[]	
#GroupThink	think:[]	group:[]	
#NoVaccinePass	no:[]	vaccine:[]	pass:[]	
#VaccineMandatesWork	vaccine:[]	work:[]	mandates:[]	
#UselessEaters	eaters:[]	useless:[]	
#YouareNotAlone	alone:[]	not:[]	youare:[]	
#GenocideByVaccin	vaccin:[]	by:[]	genocide:[]	
#RememberReme	remember:[]	reme:[]	
#IfNotMeThenWho	not:[]	me:[]	then:[]	if:[]	who:[]	
#JailDrRuben	ruben:[]	jail:[]	dr:[]	
#NoDiscriminationOnMyFlight	flight:[]	no:[]	discrimination:[]	my:[]	on:[]	
#EndAllRestrictions	all:[]	restrictions:[]	end:[]	
#DemocratsAreADisaster	a:[]	are:[]	democrats:[]	disaster:[]	
#NoPlanBNeeded	no:[]	b:[]	needed:[]	plan:[]	
#VaccinateAllTheDolls	the:[]	all:[]	vaccinate:[]	dolls:[]	
#CovidJabsArePoison	covid:[]	poison:[]	are:[]	jabs:[]	
#HellNo	no:[]	hell:[]	
#GiletsJaunes	jaunes:[]	gilets:[]	
#SpotOn	spot:[]	on:[]