#reinstateJoelSmalley	reinstate:[, accepting]	
#VaccinesSaveLungs	vaccines:[, ref:vaccine, solution]	save:[, accepting]	lungs:[, problem, ref:illness]	
#NoVaccinePassports	no:[, negation, rejecting]	vaccine:[, ref:vaccine, solution]	passports:[, ref:passport, responsibilities]	
#NoVaccinePassportsA	no:[, negation, rejecting]	vaccine:[, ref:vaccine, solution]	passports:[, ref:passport, responsibilities]	
#NorthOfTheWall	north:[, place]	
#ResigbSturgeon	sturgeon:[, personal, political, ref:nicola_sturgeon, ref:scotland]	
#MedicalExperiments	medical:[, authority, scientific]	experiments:[, scientific, solution]	
#CovidMandates	covid:[, problem, ref:covid]	mandates:[, responsibilities]	
#BringAllMPsToTheirKnees	their:[, 3rd]	
#ChildrensDay	childrens:[, social]	day:[, time]	
#SeparateSociety	society:[, social]	
#PandemicFraud	fraud:[, distrust, ref:crime, rejecting]	pandemic:[, problem, ref:illness]	
#CovidSociopth	sociopth:[, rejecting]	covid:[, problem, ref:covid]	
#ItWasAScam	scam:[, distrust, rejecting]	
#ScienceForHire	hire:[, accepting]	science:[, authority, scientific]	for:[, accepting]	
#BotswanaVariant	variant:[, problem, ref:illness]	botswana:[, place, ref:africa]	
#FactsNotFear	not:[, negation, rejecting]	facts:[, information]	fear:[, rejecting]	
#ChinaJoe	joe:[, leftwing, personal, political, ref:biden, ref:democrats]	china:[, place, ref:china]	
#SayNoToCovidTyranny	no:[, negation, rejecting]	covid:[, problem, ref:covid]	tyranny:[, distrust, rejecting]	
#DeepStates	states:[, place]	
#SmallPox	pox:[, problem, ref:illness, rejecting, vulgar]	
#WorldWideDemo	world:[, place]	
#SafeZones	safe:[, rights]	
#LeakyVaccine	vaccine:[, ref:vaccine, solution]	leaky:[, information, rejecting]	
#RiseUp	rise:[, rejecting]	
#ScienceOverFiction	fiction:[, distrust, rejecting]	science:[, authority, scientific]	
#NurseTwitter	twitter:[, information, ref:media]	nurse:[, solution]	
#TexasTaliban	taliban:[, political, rejecting]	texas:[, place, ref:america, ref:texas]	
#BigBird	bird:[, animal]	
#DanNext	next:[, time]	dan:[, personal]	
#WhereIsPengShuai	is:[, opinionated]	
#COVIDisAirb	i:[, 1st, social]	
#StairmanDan	dan:[, personal]	
#StandUpHumanRights	rights:[, rights]	stand:[, accepting]	human:[, social]	
#LetsGo	go:[, accepting]	lets:[, accepting]	
#DoNotComplyEVER	not:[, negation, rejecting]	comply:[, accepting, responsibilities]	do:[, accepting]	
#HumanRights	rights:[, rights]	human:[, social]	
#ResistTheNWO	resist:[, rejecting]	
#ShiftingNarrative	narrative:[, information]	
#NeverBelieveMaximeBernier	never:[, negation, rejecting]	maxime:[, personal]	believe:[, accepting]	
#WeStandWithAustria	austria:[, place, ref:austria]	stand:[, accepting]	we:[, 1st, social]	
#JohnsonAndJohnson	johnson:[, personal, political, ref:boris_johnson, rightwing, social]	
#AfricanAmerican	african:[, place, racial, ref:africa]	american:[, place, ref:america]	
#vaccineSideEffect	vaccine:[, ref:vaccine, solution]	effect:[, problem]	
#LongCovidKids	covid:[, problem, ref:covid]	kids:[, social]	
#AwakeYet	awake:[, accepting]	
#HumanityFirst	humanity:[, social]	
#RiseUP	rise:[, rejecting]	
#RulesForTheeNotForMe	not:[, negation, rejecting]	me:[, social]	for:[, accepting]	rules:[, responsibilities]	
#OnPoli	poli:[, political]	
#BecomeUngovernable	ungovernable:[, rejecting]	
#CovidIDIOTS	covid:[, problem, ref:covid]	i:[, 1st, social]	
#TyrantsHaveOnePlaceToSwing	tyrants:[, distrust, political, rejecting]	place:[, place]	
#NoVaccinePassportA	no:[, negation, rejecting]	vaccine:[, ref:vaccine, solution]	passport:[, ref:passport, responsibilities]	
#AntiMandates	mandates:[, responsibilities]	anti:[, rejecting]	
#TWorldCupFinal	world:[, place]	
#RedPill	red:[, political, rightwing]	pill:[, solution]	
#VaccineS	vaccine:[, ref:vaccine, solution]	
#GetYourFluShot	get:[, accepting]	your:[, 2nd, social]	flu:[, problem, ref:illness]	shot:[, ref:vaccine, solution]	
#CentralAmerica	america:[, place, ref:america]	
#CovidDerangementSyndrome	covid:[, problem, ref:covid]	syndrome:[, problem, ref:illness]	derangement:[, rejecting]	
#SturgeonSyndrome	syndrome:[, problem, ref:illness]	sturgeon:[, personal, political, ref:nicola_sturgeon, ref:scotland]	
#BorisMustGo	boris:[, personal, political, ref:boris_johnson, rightwing, social]	go:[, accepting]	must:[, responsibilities]	
#SouthAfrica	africa:[, place, ref:africa]	south:[, place]	
#FreshResists	resists:[, rejecting]	fresh:[, accepting]	
#VaxPassport	passport:[, ref:passport, responsibilities]	vax:[, ref:vaccine, solution]	
#NoCoersion	no:[, negation, rejecting]	coersion:[, rejecting]	
#WeWillNotComply	not:[, negation, rejecting]	comply:[, accepting, responsibilities]	will:[, time]	we:[, 1st, social]	
#WorldEconomicForum	forum:[, information, social]	world:[, place]	economic:[, business]	
#BlueWave	blue:[, leftwing, political]	
#DeathJabs	death:[, problem]	jabs:[, ref:vaccine, solution]	
#GreenEnergy	green:[, ref:green, solution]	energy:[, ref:energy, solution]	
#StopDiscriminating	stop:[, rejecting]	discriminating:[, racial]	
#GreaterGood	good:[, accepting]	
#ItIs	is:[, opinionated]	
#NoMoreVariants	no:[, negation, rejecting]	more:[, accepting]	variants:[, problem, ref:illness]	
#GemmaODoherty	gemma:[, personal]	
#VotePPC	vote:[, accepting]	
#vaccineRegret	vaccine:[, ref:vaccine, solution]	regret:[, rejecting]	
#CovidConspiracies	covid:[, problem, ref:covid]	conspiracies:[, distrust, rejecting]	
#MedicalApathide	apathide:[, racial, rejecting]	medical:[, authority, scientific]	
#FlipFlopFAUCI	flop:[, rejecting]	i:[, 1st, social]	
#MelbourneCup	melbourne:[, place, ref:australia]	
#GetVaccinatedBitches	bitches:[, rejecting, vulgar]	get:[, accepting]	vaccinated:[, ref:vaccine, solution]	
#CrimesA	crimes:[, problem, ref:crime, rejecting]	
#ARRESTUrsulaVonderLeyen	ursula:[, personal]	
#AlecBaldwin	alec:[, personal]	baldwin:[, personal]	
#thisisVaccineCoercion	vaccine:[, ref:vaccine, solution]	coercion:[, rejecting]	
#NoMoreLockdown	no:[, negation, rejecting]	more:[, accepting]	lockdown:[, responsibilities]	
#IStandWithKyrie	i:[, 1st, social]	kyrie:[, personal]	stand:[, accepting]	
#ClimateChange	change:[, rejecting]	climate:[, problem, ref:climate, ref:nature]	
#noVaccineMandates	no:[, negation, rejecting]	vaccine:[, ref:vaccine, solution]	mandates:[, responsibilities]	
#PfizerVaccine	vaccine:[, ref:vaccine, solution]	pfizer:[, authority, business, ref:pfizer, ref:pharma]	
#SayNoToDangerousInjections	injections:[, solution]	no:[, negation, rejecting]	dangerous:[, rejecting]	
#FireFauci	fire:[, rejecting]	fauci:[, authority, personal, ref:fauci]	
#NeverForgetNeverForgive	never:[, negation, rejecting]	forget:[, rejecting]	forgive:[, accepting]	
#ThrowAway	away:[, rejecting]	throw:[, rejecting]	
#ToldYouSo	you:[, 2nd, social]	
#NoMask	no:[, negation, rejecting]	mask:[, ref:mask, solution]	
#WakeUpWorld	world:[, place]	
#BlackPantherWakandaForever	wakanda:[, place, ref:africa]	black:[, racial]	panther:[, animal]	forever:[, time]	
#ArrestMengeleMatt	mengele:[, personal, ref:fascism, rejecting, scientific]	arrest:[, rejecting]	matt:[, personal]	
#VaccineMurder	murder:[, problem, ref:crime, rejecting]	vaccine:[, ref:vaccine, solution]	
#PaidVaxMediaScum	paid:[, business]	media:[, information, ref:media]	vax:[, ref:vaccine, solution]	scum:[, rejecting]	
#vaccineMandates	vaccine:[, ref:vaccine, solution]	mandates:[, responsibilities]	
#LaGenteComeNoiNonMollaMai	la:[, place]	
#CovidVaxExpo	covid:[, problem, ref:covid]	vax:[, ref:vaccine, solution]	expo:[, business]	
#TrudeauNationalDisgrace	trudeau:[, leftwing, personal, political, ref:trudeau, social]	national:[, place]	disgrace:[, rejecting]	
#UsForThem	for:[, accepting]	them:[, 3rd, social]	us:[, social]	
#CoerciveControl	control:[, responsibilities]	
#GetVaccinatedUK	get:[, accepting]	vaccinated:[, ref:vaccine, solution]	
#COVIDVaccineAccountability	vaccine:[, ref:vaccine, solution]	i:[, 1st, social]	accountability:[, responsibilities]	
#LasVegas	las:[, place]	
#GunViolence	violence:[, problem, ref:crime]	
#TogetherWeWin	win:[, accepting]	we:[, 1st, social]	together:[, social]	
#LeaveOurKidsA	leave:[, rejecting]	our:[, 1st, social]	kids:[, social]	
#ProtectOurChildren	children:[, social]	protect:[, accepting]	our:[, 1st, social]	
#EndVaccineMandate	mandate:[, responsibilities]	vaccine:[, ref:vaccine, solution]	end:[, rejecting]	
#WuhanF	wuhan:[, place, ref:china]	
#InternationalTravelRisks	risks:[, rejecting]	
#StandUpToPower	power:[, authority]	stand:[, accepting]	
#StopAnti	stop:[, rejecting]	anti:[, rejecting]	
#NewBrighton	brighton:[, place, ref:uk]	
#ClownVariant	variant:[, problem, ref:illness]	clown:[, rejecting]	
#VaccineM	vaccine:[, ref:vaccine, solution]	
#ShameOnGermany	shame:[, rejecting]	germany:[, place, ref:germany]	
#VaccineP	vaccine:[, ref:vaccine, solution]	
#SafeAndEffective	effective:[, accepting]	safe:[, rights]	
#MoronicV	moronic:[, rejecting]	
#WhatsNext	next:[, time]	
#NoLockdown	no:[, negation, rejecting]	lockdown:[, responsibilities]	
#CovidMisinformation	covid:[, problem, ref:covid]	misinformation:[, distrust, information, rejecting]	
#BlockchainFascism	fascism:[, distrust, ref:fascism, rejecting]	
#StopTheClotShot	clot:[, problem, ref:illness]	stop:[, rejecting]	shot:[, ref:vaccine, solution]	
#NomoreEmergencyPowers	nomore:[, rejecting]	emergency:[, problem]	powers:[, authority]	
#FarLeft	left:[, leftwing, political]	
#SackSAGE	sack:[, rejecting]	
#FreeKyle	kyle:[, personal]	free:[, rights]	
#BorisJohnsonMustGo	boris:[, personal, political, ref:boris_johnson, rightwing, social]	go:[, accepting]	must:[, responsibilities]	johnson:[, personal, political, ref:boris_johnson, rightwing, social]	
#JohnsonTheCorruptPM	corrupt:[, distrust, rejecting]	johnson:[, personal, political, ref:boris_johnson, rightwing, social]	
#ItalianDictatorship	italian:[, place, ref:italy]	dictatorship:[, distrust, political, rejecting]	
#ClimateActionNow	now:[, time]	action:[, accepting]	climate:[, problem, ref:climate, ref:nature]	
#LeftLockdownScepticsMeet	meet:[, social]	left:[, leftwing, political]	lockdown:[, responsibilities]	sceptics:[, distrust, rejecting]	
#ValueYourFreedom	freedom:[, rights]	your:[, 2nd, social]	value:[, business]	
#DefundTheMedia	defund:[, rejecting]	media:[, information, ref:media]	
#nomaskMandates	mandates:[, responsibilities]	
#AustraliaOne	australia:[, place, ref:australia]	
#HowDareYou	you:[, 2nd, social]	
#IStandWithEricClapton	clapton:[, personal]	eric:[, personal]	i:[, 1st, social]	stand:[, accepting]	
#ShameOnNaziGermany	nazi:[, distrust, ref:fascism, rejecting]	shame:[, rejecting]	germany:[, place, ref:germany]	
#NoneCompliance	compliance:[, responsibilities]	none:[, negation]	
#BatShitCrazy	bat:[, animal]	shit:[, rejecting, vulgar]	crazy:[, rejecting]	
#TheGrinch	grinch:[, rejecting]	
#NoVaccineMandatesAnywhere	no:[, negation, rejecting]	vaccine:[, ref:vaccine, solution]	mandates:[, responsibilities]	
#ThankYouBiden	biden:[, leftwing, personal, political, ref:biden, ref:democrats, social]	thank:[, accepting]	you:[, 2nd, social]	
#NoVaccinesPassportsAnywhere	no:[, negation, rejecting]	vaccines:[, ref:vaccine, solution]	passports:[, ref:passport, responsibilities]	
#NothingToFear	nothing:[, rejecting]	fear:[, rejecting]	
#VaccineInjury	vaccine:[, ref:vaccine, solution]	injury:[, problem, ref:illness]	
#NoGreenPassObbli	no:[, negation, rejecting]	green:[, ref:green, solution]	pass:[, ref:passport, responsibilities]	
#RemoveUrsulaVonderLeyen	ursula:[, personal]	remove:[, rejecting]	
#ClimateCrisis	crisis:[, problem]	climate:[, problem, ref:climate, ref:nature]	
#TheGreatGlobalPushback	global:[, place]	great:[, accepting]	
#StopTesting	stop:[, rejecting]	testing:[, solution]	
#StopTestingChildren	stop:[, rejecting]	children:[, social]	testing:[, solution]	
#PedsICU	peds:[, rejecting]	i:[, 1st, social]	
#PremierLeague	league:[, social]	premier:[, political]	
#medicalApartheid	medical:[, authority, scientific]	apartheid:[, political, racial, rejecting]	
#DemocratsHateAmerica	democrats:[, leftwing, political, ref:democrats]	hate:[, rejecting]	america:[, place, ref:america]	
#CCPVirus	virus:[, problem, ref:illness]	
#DefyBrandon	brandon:[, personal, political, rightwing]	defy:[, rejecting]	
#NoHealthPass	no:[, negation, rejecting]	pass:[, ref:passport, responsibilities]	health:[, rights]	
#notCoincidence	not:[, negation, rejecting]	
#NoNutNovember	november:[, time]	no:[, negation, rejecting]	nut:[, rejecting]	
#GlobalistTraitorDonnelly	traitor:[, distrust, rejecting]	donnelly:[, personal]	globalist:[, rejecting]	
#QuestionAuthority	question:[, rejecting]	authority:[, authority]	
#DrGlynn	dr:[, authority]	
#HeGetsIt	gets:[, accepting]	he:[, social]	
#TakeOffYourPoppy	take:[, accepting]	poppy:[, personal]	your:[, 2nd, social]	
#PandemicOfTheVaxxed	vaxxed:[, solution]	pandemic:[, problem, ref:illness]	
#LetsGoBr	go:[, accepting]	lets:[, accepting]	
#ScottMorrison	scott:[, personal, political, ref:scott_morrison, rightwing]	morrison:[, personal, political, ref:scott_morrison, rightwing]	
#CovidVaccin	vaccin:[, ref:vaccine, solution]	covid:[, problem, ref:covid]	
#COVIDBoosterShots	i:[, 1st, social]	shots:[, ref:vaccine, solution]	booster:[, ref:vaccine, solution]	
#BoosterScam	scam:[, distrust, rejecting]	booster:[, ref:vaccine, solution]	
#ScumMedia	media:[, information, ref:media]	scum:[, rejecting]	
#RefuseToLose	refuse:[, rejecting]	lose:[, rejecting]	
#DanAndrews	dan:[, personal]	andrews:[, personal]	
#NoMandatoryVaccines	no:[, negation, rejecting]	vaccines:[, ref:vaccine, solution]	mandatory:[, responsibilities]	
#NorthernIreland	northern:[, place]	ireland:[, place, ref:ireland]	
#EvilCCP	evil:[, ref:crime, rejecting]	
#SlipperySlopeToHell	hell:[, rejecting]	slippery:[, rejecting]	
#WarCrimes	crimes:[, problem, ref:crime, rejecting]	war:[, rejecting]	
#covidCanada	covid:[, problem, ref:covid]	canada:[, place, ref:canada]	
#FollowTheMoney	money:[, business]	follow:[, accepting]	
#vaccineExposed	vaccine:[, ref:vaccine, solution]	exposed:[, rejecting]	
#LiftTheVeil	lift:[, rejecting]	
#AntiTyranny	tyranny:[, distrust, rejecting]	anti:[, rejecting]	
#ChrisS	chris:[, personal]	
#NaturalImmunity	immunity:[, solution]	
#NotInTheMood	not:[, negation, rejecting]	
#NoVoterID	no:[, negation, rejecting]	i:[, 1st, social]	voter:[, political]	
#vaxNazis	vax:[, ref:vaccine, solution]	nazis:[, distrust, political, ref:fascism, rejecting]	
#NotOnTheNews	news:[, information, ref:media]	not:[, negation, rejecting]	
#DeathByPolititian	death:[, problem]	
#GetFucked	get:[, accepting]	fucked:[, rejecting, vulgar]	
#BorisIsFinished	boris:[, personal, political, ref:boris_johnson, rightwing, social]	is:[, opinionated]	
#MoreOfUs	more:[, accepting]	us:[, social]	
#ThisHill	hill:[, place]	
#LeSnitch	snitch:[, rejecting]	
#InternmentCampsAustralia	camps:[, place, rejecting]	australia:[, place, ref:australia]	internment:[, responsibilities]	
#NBPoli	poli:[, political]	
#FascistOfTheDay	fascist:[, distrust, political, ref:fascism, rejecting]	day:[, time]	
#NoGreenpass	no:[, negation, rejecting]	
#TravisScott	travis:[, place]	scott:[, personal, political, ref:scott_morrison, rightwing]	
#CovidVicData	covid:[, problem, ref:covid]	data:[, information, scientific]	
#DiedSuddenly	died:[, problem]	
#CancelDougFord	cancel:[, rejecting]	doug:[, personal]	ford:[, business, personal]	
#AntiSemitism	semitism:[, racial]	anti:[, rejecting]	
#mandatoryVaccination	mandatory:[, responsibilities]	vaccination:[, ref:vaccine, solution]	
#ResignBoris	boris:[, personal, political, ref:boris_johnson, rightwing, social]	resign:[, rejecting]	
#NewYorkNadia	nadia:[, personal]	york:[, place, ref:uk]	
#EarlyTreatmentWorks	treatment:[, solution]	early:[, time]	
#VaccineSid	vaccine:[, ref:vaccine, solution]	
#EricCla	eric:[, personal]	
#ResistanceUnited	united:[, accepting]	resistance:[, rejecting]	
#SustainableDevelopmentGoals	development:[, business]	sustainable:[, solution]	goals:[, accepting]	
#ErinOtoole	otoole:[, personal]	
#PandemicOfCorruption	pandemic:[, problem, ref:illness]	corruption:[, distrust, rejecting]	
#NonAu	au:[, place, ref:australia]	
#UnifiedNonCompliance	compliance:[, responsibilities]	unified:[, accepting, social]	
#ThankYouBrandon	brandon:[, personal, political, rightwing]	thank:[, accepting]	you:[, 2nd, social]	
#SocialEngeneering	social:[, social]	
#PfizerGate	pfizer:[, authority, business, ref:pfizer, ref:pharma]	gate:[, distrust, political, rejecting]	
#VFDraghi	draghi:[, personal]	
#vaccineSideEffects	effects:[, problem]	vaccine:[, ref:vaccine, solution]	
#ScamDemic	scam:[, distrust, rejecting]	
#TaxationIsTheft	is:[, opinionated]	theft:[, ref:crime, rejecting]	taxation:[, business]	
#AustraliaHasFallen	fallen:[, personal]	australia:[, place, ref:australia]	
#CrimesAgainstHumanity	against:[, rejecting]	crimes:[, problem, ref:crime, rejecting]	humanity:[, social]	
#strandedAussies	stranded:[, problem]	aussies:[, place, ref:australia]	
#NoMeansNo	no:[, negation, rejecting]	
#FoxyFauci	foxy:[, accepting]	fauci:[, authority, personal, ref:fauci]	
#AllTrials	trials:[, scientific, solution]	
#DeBl	de:[, personal]	
#AustriaMustNotFall	not:[, negation, rejecting]	fall:[, rejecting]	must:[, responsibilities]	austria:[, place, ref:austria]	
#FireDeSantis	de:[, personal]	santis:[, personal, ref:ron_desantis]	fire:[, rejecting]	
#WeSeeYou	you:[, 2nd, social]	we:[, 1st, social]	
#VoteThemAllOut	them:[, 3rd, social]	vote:[, accepting]	
#NFLTwitter	twitter:[, information, ref:media]	
#OrganizedCrime	organized:[, social]	crime:[, ref:crime, rejecting]	
#SackJavid	sack:[, rejecting]	javid:[, personal]	
#SOSAustralia	australia:[, place, ref:australia]	
#CentralPark	park:[, place]	
#NickFuentes	nick:[, personal]	
#GavinNewsom	gavin:[, leftwing, personal, political, ref:california, ref:democrats, ref:gavin_newsom]	newsom:[, leftwing, personal, political, ref:gavin_newsom]	
#BodyAutonomy	autonomy:[, rights]	body:[, social]	
#PCRTests	tests:[, information]	
#BlackLivesMatter	lives:[, social]	black:[, racial]	
#WeAreWINNING	are:[, opinionated]	i:[, 1st, social]	we:[, 1st, social]	
#UnitedNations	united:[, accepting]	nations:[, place]	
#ProblemSolved	problem:[, problem]	
#TheCorporation	corporation:[, business]	
#YoursHasToxins	toxins:[, problem, ref:illness, ref:nature]	yours:[, 2nd, social]	
#DONOTComply	comply:[, accepting, responsibilities]	
#CovidPass	covid:[, problem, ref:covid]	pass:[, ref:passport, responsibilities]	
#BearsFans	bears:[, animal]	fans:[, accepting]	
#StandUpHumanRig	stand:[, accepting]	human:[, social]	
#FakeNews	news:[, information, ref:media]	fake:[, distrust, rejecting]	
#SliwaForMayor	mayor:[, political]	for:[, accepting]	
#NoNHSMandates	no:[, negation, rejecting]	mandates:[, responsibilities]	
#WeMustResist	resist:[, rejecting]	must:[, responsibilities]	we:[, 1st, social]	
#VaccineGenocide	vaccine:[, ref:vaccine, solution]	genocide:[, ref:crime, rejecting]	
#NoLockdownForUnvaccinated	no:[, negation, rejecting]	unvaccinated:[, ref:vaccine, rejecting]	for:[, accepting]	lockdown:[, responsibilities]	
#SpikeProtein	spike:[, problem]	
#SouthPark	south:[, place]	park:[, place]	
#UslessEaters	usless:[, rejecting]	
#AustraliaHa	australia:[, place, ref:australia]	
#PredatorProducer	predator:[, animal, rejecting]	
#BorisJohnWorstPMever	boris:[, personal, political, ref:boris_johnson, rightwing, social]	worst:[, rejecting]	john:[, personal]	
#KrispyKreme	krispy:[, business]	kreme:[, business]	
#FreedomDay	freedom:[, rights]	day:[, time]	
#JailScottMorrison	jail:[, ref:crime, rejecting]	scott:[, personal, political, ref:scott_morrison, rightwing]	morrison:[, personal, political, ref:scott_morrison, rightwing]	
#TheGreatAwakening	awakening:[, accepting]	great:[, accepting]	
#ZombieLove	love:[, accepting]	zombie:[, rejecting]	
#facts#Truths	truths:[, information]	facts:[, information]	
#DavosSecrets	davos:[, personal, political, rightwing]	
#BeThisGuy	be:[, accepting]	
#NuVariante	variante:[, problem, ref:illness]	
#StopCo	stop:[, rejecting]	co:[, problem, ref:carbon, ref:nature]	
#StopTheSpread	stop:[, rejecting]	spread:[, problem]	
#BulgarianGovernment	government:[, authority]	bulgarian:[, place]	
#FluFactFriday	fact:[, information]	friday:[, time]	flu:[, problem, ref:illness]	
#RodStewart	stewart:[, personal]	
#StayStrong	strong:[, accepting]	stay:[, accepting]	
#AlexBerenson	alex:[, personal]	
#NoMandatedFirings	firings:[, rejecting]	no:[, negation, rejecting]	mandated:[, responsibilities]	
#BigPharma	pharma:[, business, ref:pharma]	
#HistoryRepeatingItself	history:[, time]	
#ScienceDeniers	science:[, authority, scientific]	deniers:[, distrust, rejecting]	
#PrimeMinister	minister:[, political]	
#ItWasaScam	scam:[, distrust, rejecting]	
#MorningLive	live:[, rights]	morning:[, time]	
#LongCovid	covid:[, problem, ref:covid]	
#FightBackBetter	better:[, accepting]	fight:[, rejecting]	
#EUFluDay	day:[, time]	flu:[, problem, ref:illness]	
#DowningStreetBriefing	street:[, place]	downing:[, place]	briefing:[, information]	
#HistoryRepeats	history:[, time]	
#MustWatch	must:[, responsibilities]	
#CovidPassport	covid:[, problem, ref:covid]	passport:[, ref:passport, responsibilities]	
#NoVaccinePassPorts	no:[, negation, rejecting]	vaccine:[, ref:vaccine, solution]	pass:[, ref:passport, responsibilities]	ports:[, place]	
#FordfailedOntario	fordfailed:[, political, rejecting]	ontario:[, place, ref:canada]	
#QuestionEverything	question:[, rejecting]	
#ClimateC	climate:[, problem, ref:climate, ref:nature]	
#GoHomeBillGates	gates:[, personal, ref:bill_gates]	go:[, accepting]	bill:[, political]	home:[, social]	
#NoDigitalI	digital:[, solution]	no:[, negation, rejecting]	i:[, 1st, social]	
#TrustTheScience	trust:[, accepting]	science:[, authority, scientific]	
#whiteSupremacists	supremacists:[, racial, rejecting]	white:[, racial]	
#NoVaccinesPassport	no:[, negation, rejecting]	passport:[, ref:passport, responsibilities]	vaccines:[, ref:vaccine, solution]	
#LISTENtoExperts	i:[, 1st, social]	experts:[, authority]	
#SouthAustraliaMagistratesCourt	south:[, place]	magistrates:[, authority]	australia:[, place, ref:australia]	court:[, authority]	
#FuelPriceHike	price:[, business]	
#RareDisease	disease:[, problem, ref:illness]	
#GlobalNonCompliance	compliance:[, responsibilities]	global:[, place]	
#WillNotComply	not:[, negation, rejecting]	comply:[, accepting, responsibilities]	will:[, time]	
#BigPharmaTyranny	tyranny:[, distrust, rejecting]	pharma:[, business, ref:pharma]	
#TruthMatters	truth:[, information, rights]	
#ArrestMarkAndrews	arrest:[, rejecting]	andrews:[, personal]	
#AustraliaHasNotFallen	not:[, negation, rejecting]	fallen:[, personal]	australia:[, place, ref:australia]	
#GQPDomesticTer	domestic:[, place]	q:[, political, ref:q, rightwing]	
#TrendWorldWide	world:[, place]	
#NonAuPassDeLaHonte	de:[, personal]	au:[, place, ref:australia]	la:[, place]	pass:[, ref:passport, responsibilities]	
#ImHealthy	im:[, 1st, social]	healthy:[, rights]	
#CovidHoax	covid:[, problem, ref:covid]	hoax:[, distrust, rejecting]	
#COVIDVaccine	vaccine:[, ref:vaccine, solution]	i:[, 1st, social]	
#MRNAVaccines	vaccines:[, ref:vaccine, solution]	
#RepublicansHateScience	republicans:[, political, ref:republicans, rightwing]	science:[, authority, scientific]	hate:[, rejecting]	
#PlannedNonsense	nonsense:[, rejecting]	
#WhitePrivilege	white:[, racial]	privilege:[, rights]	
#CriticalThinking	critical:[, rejecting]	thinking:[, accepting]	
#LoveOneAnother	love:[, accepting]	
#MoreOfThis	more:[, accepting]	
#PirateChain	chain:[, social]	pirate:[, rejecting]	
#StarTrek	star:[, accepting]	
#ItalyProtests	protests:[, rejecting]	italy:[, place, ref:italy]	
#PCRFraud	fraud:[, distrust, ref:crime, rejecting]	
#FakeNewsMedia	news:[, information, ref:media]	fake:[, distrust, rejecting]	media:[, information, ref:media]	
#FauciLiedPeopleDi	fauci:[, authority, personal, ref:fauci]	people:[, social]	lied:[, distrust, rejecting]	
#RemoveGerryHorkan	gerry:[, personal]	remove:[, rejecting]	
#MichelleGoszko	michelle:[, personal]	
#NoVaccines	no:[, negation, rejecting]	vaccines:[, ref:vaccine, solution]	
#NetworkAnalysis	analysis:[, information]	network:[, business]	
#NoMandatoryV	no:[, negation, rejecting]	mandatory:[, responsibilities]	
#ConspiracyTheories	conspiracy:[, distrust, rejecting]	theories:[, scientific]	
#ItIsNotAVaccine	vaccine:[, ref:vaccine, solution]	not:[, negation, rejecting]	is:[, opinionated]	
#CoronaMadness	madness:[, rejecting]	corona:[, problem, ref:corona, ref:illness]	
#AaronRodgers	aaron:[, personal, ref:aaron_rodgers]	rodgers:[, personal, ref:aaron_rodgers]	
#TheVirusParty	virus:[, problem, ref:illness]	party:[, political]	
#WeWillNOTcomply	will:[, time]	we:[, 1st, social]	
#CovidVaccineKills	kills:[, ref:crime, rejecting]	vaccine:[, ref:vaccine, solution]	covid:[, problem, ref:covid]	
#DrRobertMalone	robert:[, personal]	malone:[, authority, personal, ref:robert_malone]	dr:[, authority]	
#CoronaVaccine	vaccine:[, ref:vaccine, solution]	corona:[, problem, ref:corona, ref:illness]	
#MeToo	me:[, social]	
#ChampsElysees	champs:[, accepting]	
#NewYorkCity	city:[, place]	york:[, place, ref:uk]	
#AntivaxPremier	premier:[, political]	antivax:[, ref:vaccine, rejecting, solution]	
#HowardSprings	howard:[, personal]	
#VaccinationIsNotCompulsary	compulsary:[, responsibilities]	not:[, negation, rejecting]	is:[, opinionated]	vaccination:[, ref:vaccine, solution]	
#ExposePfizer	pfizer:[, authority, business, ref:pfizer, ref:pharma]	expose:[, rejecting]	
#NoMoreAbuse	no:[, negation, rejecting]	abuse:[, rejecting]	more:[, accepting]	
#BidenBorderVirus	border:[, place]	biden:[, leftwing, personal, political, ref:biden, ref:democrats, social]	virus:[, problem, ref:illness]	
#GlobalCovidNazis	covid:[, problem, ref:covid]	global:[, place]	nazis:[, distrust, political, ref:fascism, rejecting]	
#NonAuVaccinObligatoire	vaccin:[, ref:vaccine, solution]	au:[, place, ref:australia]	obligatoire:[, responsibilities]	
#DontBuyFromDischem	dont:[, negation, rejecting]	
#COVIDVaccination	i:[, 1st, social]	vaccination:[, ref:vaccine, solution]	
#BorisHasFailedTheNation	nation:[, place]	boris:[, personal, political, ref:boris_johnson, rightwing, social]	failed:[, rejecting]	
#FoodShortages	shortages:[, problem]	
#WorldWideAwakening	world:[, place]	awakening:[, accepting]	
#CovidVaxExp	covid:[, problem, ref:covid]	vax:[, ref:vaccine, solution]	
#AuditAllStates	audit:[, business]	states:[, place]	
#MillionMaskMarch	million:[, numeric]	mask:[, ref:mask, solution]	
#NoCRT	no:[, negation, rejecting]	
#NoToDivision	no:[, negation, rejecting]	
#DeathCult	cult:[, distrust, rejecting]	death:[, problem]	
#PayAttention	pay:[, business]	
#CPCNonsense	nonsense:[, rejecting]	
#EarlyTreatment	treatment:[, solution]	early:[, time]	
#VaccinesSaveLive	vaccines:[, ref:vaccine, solution]	save:[, accepting]	live:[, rights]	
#DrBonnieHenry	henry:[, personal]	bonnie:[, personal]	dr:[, authority]	
#BrooklynNets	brooklyn:[, place, ref:america, ref:new_york]	
#SolidaritywithLithuania	lithuania:[, place, ref:europe]	
#TheRealAnthonyFauci	fauci:[, authority, personal, ref:fauci]	real:[, accepting]	
#RejectTheReset	reject:[, rejecting]	reset:[, rejecting]	
#NoFear	no:[, negation, rejecting]	fear:[, rejecting]	
#fireBonnie	bonnie:[, personal]	fire:[, rejecting]	
#AskingForAFriend	asking:[, information]	friend:[, social]	for:[, accepting]	
#NovaccineMandates	mandates:[, responsibilities]	
#AntiPlandemic	plandemic:[, distrust, rejecting]	anti:[, rejecting]	
#SayNoToBillGates	gates:[, personal, ref:bill_gates]	no:[, negation, rejecting]	bill:[, political]	
#GoScience	science:[, authority, scientific]	go:[, accepting]	
#ShitCharlie	shit:[, rejecting, vulgar]	charlie:[, personal]	
#NavyWife	wife:[, social]	
#CovidHo	covid:[, problem, ref:covid]	
#KillTheBill	bill:[, political]	kill:[, problem, ref:crime, rejecting]	
#VaccineManda	vaccine:[, ref:vaccine, solution]	
#CovidTyranny	covid:[, problem, ref:covid]	tyranny:[, distrust, rejecting]	
#MasksSaveLives	lives:[, social]	save:[, accepting]	masks:[, ref:mask, solution]	
#ArronRodgers	rodgers:[, personal, ref:aaron_rodgers]	
#BritishTV	british:[, place, ref:uk]	
#DansLockoutFail	fail:[, rejecting]	
#NoMedicalFascism	no:[, negation, rejecting]	medical:[, authority, scientific]	fascism:[, distrust, ref:fascism, rejecting]	
#KillSho	kill:[, problem, ref:crime, rejecting]	
#TakeOffYo	take:[, accepting]	
#NotMyCanada	not:[, negation, rejecting]	canada:[, place, ref:canada]	my:[, 1st, social]	
#OAPAbuse	abuse:[, rejecting]	
#NoVaccineP	no:[, negation, rejecting]	vaccine:[, ref:vaccine, solution]	
#NoVaccineM	no:[, negation, rejecting]	vaccine:[, ref:vaccine, solution]	
#NoJabsForKids	no:[, negation, rejecting]	for:[, accepting]	jabs:[, ref:vaccine, solution]	kids:[, social]	
#QRweigeraar	q:[, political, ref:q, rightwing]	
#BoycottPeterBurgers	peter:[, personal]	boycott:[, rejecting]	
#StopPassSanitaire	stop:[, rejecting]	pass:[, ref:passport, responsibilities]	sanitaire:[, solution]	
#DemVoi	dem:[, leftwing, political, ref:democrats]	
#ToriesAreToast	tories:[, political, ref:uk, rightwing]	are:[, opinionated]	
#NoVaccinepassportsanywhere	no:[, negation, rejecting]	
#StongerTogether	together:[, social]	
#RandyHillier	randy:[, personal]	
#SackBorisJohnson	sack:[, rejecting]	boris:[, personal, political, ref:boris_johnson, rightwing, social]	johnson:[, personal, political, ref:boris_johnson, rightwing, social]	
#hOLDtHElINE	i:[, 1st, social]	
#NoMoreFakeNews	news:[, information, ref:media]	no:[, negation, rejecting]	more:[, accepting]	fake:[, distrust, rejecting]	
#VaccineEconomics	economics:[, business]	vaccine:[, ref:vaccine, solution]	
#ElectionDay	election:[, political]	day:[, time]	
#CovidCommunism	covid:[, problem, ref:covid]	communism:[, leftwing, political]	
#SouthwestEmployees	employees:[, business]	
#FamilyMeeting	family:[, social]	meeting:[, social]	
#YouTube	you:[, 2nd, social]	
#VaccineHarm	vaccine:[, ref:vaccine, solution]	harm:[, problem]	
#NaziUrsulaVonderLeyen	nazi:[, distrust, ref:fascism, rejecting]	ursula:[, personal]	
#NewYorkTimes	times:[, time]	york:[, place, ref:uk]	
#NoVaccinePassportAnywhere	no:[, negation, rejecting]	vaccine:[, ref:vaccine, solution]	passport:[, ref:passport, responsibilities]	
#NphetOutNow	now:[, time]	nphet:[, authority]	
#BonnieHenrys	bonnie:[, personal]	
#JusticeMatters	justice:[, rights]	
#PiersCorbyn	corbyn:[, leftwing, personal, political]	piers:[, personal]	
#CoronaViru	corona:[, problem, ref:corona, ref:illness]	
#HappyHalloween	halloween:[, time]	happy:[, accepting]	
#NewJersey	jersey:[, place, ref:uk]	
#JohnsonLiedPeopleDied	died:[, problem]	johnson:[, personal, political, ref:boris_johnson, rightwing, social]	people:[, social]	lied:[, distrust, rejecting]	
#ShameOnNaziAustralia	nazi:[, distrust, ref:fascism, rejecting]	shame:[, rejecting]	australia:[, place, ref:australia]	
#DefundThePolice	defund:[, rejecting]	police:[, authority]	
#NoVaccinePassportsForWales	no:[, negation, rejecting]	vaccine:[, ref:vaccine, solution]	for:[, accepting]	wales:[, place, ref:uk, ref:wales]	passports:[, ref:passport, responsibilities]	
#WinterOlympics	winter:[, time]	
#LiveFreeOrDie	die:[, rejecting]	free:[, rights]	live:[, rights]	
#HoldFirm	firm:[, business]	
#NoNetZero	zero:[, rejecting]	no:[, negation, rejecting]	
#MichaelYeadon	michael:[, personal]	
#ThankYou	thank:[, accepting]	you:[, 2nd, social]	
#boycottMSM	boycott:[, rejecting]	
#EndTheMandates	end:[, rejecting]	mandates:[, responsibilities]	
#jaconfaArdern	ardern:[, personal, ref:jacinda_ardern]	
#FcukOffHolohan	holohan:[, authority, personal, ref:tony_holohan]	fcuk:[, rejecting, vulgar]	
#CovidGesetzNein	covid:[, problem, ref:covid]	
#LandOfTheFree	land:[, place]	free:[, rights]	
#ThursdayNightClap	clap:[, accepting]	night:[, time]	thursday:[, time]	
#StopQRankzinnigheid	q:[, political, ref:q, rightwing]	stop:[, rejecting]	
#COVIDisCommunism	i:[, 1st, social]	communism:[, leftwing, political]	
#ScienceSaves	science:[, authority, scientific]	
#NHSPressure	pressure:[, rejecting]	
#PseudoScience	science:[, authority, scientific]	pseudo:[, rejecting]	
#BelgiansForFreedom	freedom:[, rights]	for:[, accepting]	belgians:[, place, ref:belgium]	
#italiaNONmolla	italia:[, place, ref:italy]	
#BoycottSainsburys	sainsburys:[, business, ref:uk]	boycott:[, rejecting]	
#LockupMichaelMartin	michael:[, personal]	lockup:[, rejecting]	martin:[, personal]	
#AntiScience	science:[, authority, scientific]	anti:[, rejecting]	
#VanGran	gran:[, social]	
#CyrilMustGo	cyril:[, personal]	go:[, accepting]	must:[, responsibilities]	
#GetABooster	get:[, accepting]	booster:[, ref:vaccine, solution]	
#NYCMayorElect	mayor:[, political]	
#WearMasks	wear:[, accepting]	masks:[, ref:mask, solution]	
#NoMaskMandates	no:[, negation, rejecting]	mandates:[, responsibilities]	mask:[, ref:mask, solution]	
#ItEnd	end:[, rejecting]	
#LeaveOurKi	leave:[, rejecting]	our:[, 1st, social]	
#CorporateManslaughter	corporate:[, business]	manslaughter:[, problem, ref:crime]	
#NaziNPHET	nazi:[, distrust, ref:fascism, rejecting]	
#TorySewageParty	tory:[, political, rightwing]	party:[, political]	sewage:[, problem, ref:nature, rejecting]	
#BoosterClub	club:[, social]	booster:[, ref:vaccine, solution]	
#ThatsNotHowThisWorks	not:[, negation, rejecting]	
#NoplanB	noplan:[, negation, rejecting]	
#CuyahogaCounty	county:[, place]	
#HelpOthersGetVacci	help:[, accepting]	vacci:[, ref:vaccine, solution]	get:[, accepting]	others:[, social]	
#YorkProtest	york:[, place, ref:uk]	protest:[, rejecting]	
#SayNoToTheJab	no:[, negation, rejecting]	jab:[, ref:vaccine, solution]	
#ArrestTrumpNow	trump:[, personal, political, ref:donald_trump, ref:trump, rightwing, social]	arrest:[, rejecting]	now:[, time]	
#NoBailForBillGates	gates:[, personal, ref:bill_gates]	no:[, negation, rejecting]	for:[, accepting]	bill:[, political]	
#BelfastProtest	belfast:[, place, ref:uk]	protest:[, rejecting]	
#StandWithKyrie	kyrie:[, personal]	stand:[, accepting]	
#CallItWhatItIs	is:[, opinionated]	
#DeSantis	de:[, personal]	santis:[, personal, ref:ron_desantis]	
#GoldCoastNe	coast:[, place]	
#AlexanderSchallenberg	alexander:[, personal]	
#CovidScam	covid:[, problem, ref:covid]	scam:[, distrust, rejecting]	
#FluAwareness	awareness:[, information]	flu:[, problem, ref:illness]	
#OntariosPrivatizedGovernment	government:[, authority]	ontarios:[, place, ref:canada]	
#BanC	ban:[, rejecting]	
#LiberalProgressives	progressives:[, leftwing, political]	liberal:[, leftwing, political]	
#VaccineDeaths	vaccine:[, ref:vaccine, solution]	deaths:[, problem]	
#NoTyranny	no:[, negation, rejecting]	tyranny:[, distrust, rejecting]	
#AntiMask	mask:[, ref:mask, solution]	anti:[, rejecting]	
#StarWars	star:[, accepting]	wars:[, problem]	
#ImpeachBiden	biden:[, leftwing, personal, political, ref:biden, ref:democrats, social]	impeach:[, rejecting]	
#CanadaHasFallen	fallen:[, personal]	canada:[, place, ref:canada]	
#DrHilary	dr:[, authority]	hilary:[, leftwing, personal, political, ref:clinton, ref:hillary_clinton, social]	
#PuertoRicoDoesItBetter	better:[, accepting]	puerto:[, place]	
#ArrestBorisJohnson	arrest:[, rejecting]	boris:[, personal, political, ref:boris_johnson, rightwing, social]	johnson:[, personal, political, ref:boris_johnson, rightwing, social]	
#NotAboutHealth	not:[, negation, rejecting]	health:[, rights]	
#FactCheck	fact:[, information]	
#CovidW	covid:[, problem, ref:covid]	
#ArrestBillGates	gates:[, personal, ref:bill_gates]	arrest:[, rejecting]	bill:[, political]	
#VaccineRolloutSA	vaccine:[, ref:vaccine, solution]	
#ProtecttheChildren	children:[, social]	
#HumanRightsViola	rights:[, rights]	human:[, social]	
#ModernDayTyranny	tyranny:[, distrust, rejecting]	modern:[, accepting]	day:[, time]	
#ClimateEmergency	emergency:[, problem]	climate:[, problem, ref:climate, ref:nature]	
#VAERSIndia	india:[, place, ref:india]	
#NoBailouts	no:[, negation, rejecting]	
#WeLoveNovakDjokovic	love:[, accepting]	novak:[, personal, ref:novak_djokovic]	we:[, 1st, social]	djokovic:[, personal, ref:novak_djokovic]	
#RTEFakeNews	news:[, information, ref:media]	fake:[, distrust, rejecting]	
#CultOfCovid	covid:[, problem, ref:covid]	cult:[, distrust, rejecting]	
#CovidTesting	covid:[, problem, ref:covid]	testing:[, solution]	
#SaveTheChildren	children:[, social]	save:[, accepting]	
#NursingHomeGenocide	genocide:[, ref:crime, rejecting]	nursing:[, solution]	home:[, social]	
#StandToGether	stand:[, accepting]	
#WearaDamnMask	damn:[, rejecting]	mask:[, ref:mask, solution]	
#Corrupt#SajidJavid	corrupt:[, distrust, rejecting]	sajid:[, personal, political, rightwing]	javid:[, personal]	
#BidenBorderCrisis	border:[, place]	biden:[, leftwing, personal, political, ref:biden, ref:democrats, social]	crisis:[, problem]	
#NoNakedNostrils	no:[, negation, rejecting]	
#BornBFree	free:[, rights]	
#NewYork	york:[, place, ref:uk]	
#QRcode	q:[, political, ref:q, rightwing]	
#InThisTogether	together:[, social]	
#disbandNphet	nphet:[, authority]	disband:[, rejecting]	
#AntibodyDependentEnhancement	antibody:[, solution]	enhancement:[, accepting]	
#CovidIsNotGone	not:[, negation, rejecting]	covid:[, problem, ref:covid]	is:[, opinionated]	
#noID	no:[, negation, rejecting]	i:[, 1st, social]	
#WashYourHands	your:[, 2nd, social]	
#CyberBullying	cyber:[, scientific]	bullying:[, rejecting]	
#NeverAgain	never:[, negation, rejecting]	
#DeBlasioTookOurPay	de:[, personal]	blasio:[, leftwing, personal, political, ref:bill_deblasio, ref:democrats]	pay:[, business]	our:[, 1st, social]	
#YouAreNotAlone	not:[, negation, rejecting]	are:[, opinionated]	you:[, 2nd, social]	
#PoliceBrutality	police:[, authority]	
#LiberalismIsAMentalDisorder	liberalism:[, leftwing, political]	disorder:[, problem, ref:illness]	is:[, opinionated]	
#BillgatesIsEvil	is:[, opinionated]	evil:[, ref:crime, rejecting]	
#CovidVacci	vacci:[, ref:vaccine, solution]	covid:[, problem, ref:covid]	
#NOTaVaccine	vaccine:[, ref:vaccine, solution]	
#TakeAmericaBack	take:[, accepting]	america:[, place, ref:america]	
#NoPassports	no:[, negation, rejecting]	passports:[, ref:passport, responsibilities]	
#WalkingBrainDead	dead:[, problem]	
#ArrestThemAll	arrest:[, rejecting]	them:[, 3rd, social]	
#ResignSturgeon	sturgeon:[, personal, political, ref:nicola_sturgeon, ref:scotland]	resign:[, rejecting]	
#UniteNow	unite:[, social]	now:[, time]	
#VaccinationMandate	mandate:[, responsibilities]	vaccination:[, ref:vaccine, solution]	
#WideAwake	awake:[, accepting]	
#LetsG	lets:[, accepting]	
#NoVaccinePassportAnywh	no:[, negation, rejecting]	vaccine:[, ref:vaccine, solution]	passport:[, ref:passport, responsibilities]	
#MunchausensByProxy	munchausens:[, problem, ref:illness]	
#NoToCovidChildrenVaccine	no:[, negation, rejecting]	vaccine:[, ref:vaccine, solution]	covid:[, problem, ref:covid]	children:[, social]	
#digitalIdentity	digital:[, solution]	
#NewWorldWorder	world:[, place]	
#MelbourneProtest	protest:[, rejecting]	melbourne:[, place, ref:australia]	
#COVIDIOTs	i:[, 1st, social]	
#OpNazi	nazi:[, distrust, ref:fascism, rejecting]	
#StopLine	stop:[, rejecting]	
#TraderJoes	trader:[, business]	
#StopKillingKids	stop:[, rejecting]	killing:[, ref:crime, rejecting]	kids:[, social]	
#EndTheFed	fed:[, authority]	end:[, rejecting]	
#AustraliaHASFALLEN	australia:[, place, ref:australia]	
#AntiVaxxer	vaxxer:[, ref:vaccine, solution]	anti:[, rejecting]	
#ArrestFauciNow	arrest:[, rejecting]	now:[, time]	fauci:[, authority, personal, ref:fauci]	
#MasksAreUseless	are:[, opinionated]	useless:[, rejecting]	masks:[, ref:mask, solution]	
#auspoI	auspo:[, place, ref:australia]	i:[, 1st, social]	
#BrandonAdministration	brandon:[, personal, political, rightwing]	administration:[, authority]	
#NeverVoteC	never:[, negation, rejecting]	vote:[, accepting]	
#QRc	q:[, political, ref:q, rightwing]	
#CatholicTwitter	twitter:[, information, ref:media]	catholic:[, religious]	
#VaccinationsSaveLives	lives:[, social]	vaccinations:[, ref:vaccine, solution]	save:[, accepting]	
#NoLFTesting	no:[, negation, rejecting]	testing:[, solution]	
#BeLikeAustria	be:[, accepting]	austria:[, place, ref:austria]	
#FactCheckTHIS	fact:[, information]	i:[, 1st, social]	
#VaccineRelated	vaccine:[, ref:vaccine, solution]	
#BigStop	stop:[, rejecting]	
#AreYouAwakeYet	are:[, opinionated]	awake:[, accepting]	you:[, 2nd, social]	
#MelbourneRises	melbourne:[, place, ref:australia]	
#EnoughCOVIDBullshit	i:[, 1st, social]	bullshit:[, distrust, rejecting, vulgar]	
#FoxAndFriends	friends:[, social]	fox:[, information, ref:fox_news, ref:media]	
#NoMoreLies	no:[, negation, rejecting]	more:[, accepting]	lies:[, distrust, information, rejecting]	
#BigGov	gov:[, authority, political]	
#ThisIsTheirShot	their:[, 3rd]	is:[, opinionated]	shot:[, ref:vaccine, solution]	
#CanYou	you:[, 2nd, social]	
#VaccinesWork	vaccines:[, ref:vaccine, solution]	work:[, responsibilities]	
#SteveBannon	steve:[, personal]	bannon:[, personal, political, ref:steve_bannon, rightwing]	
#VaccineTyranny	vaccine:[, ref:vaccine, solution]	tyranny:[, distrust, rejecting]	
#StandWithPerth	perth:[, place, ref:australia]	stand:[, accepting]	
#GeneralStrike	general:[, authority]	strike:[, rejecting]	
#HelpOthersGetVaccinated	help:[, accepting]	get:[, accepting]	vaccinated:[, ref:vaccine, solution]	others:[, social]	
#IrelandsFittestFamily	irelands:[, place, ref:europe, ref:ireland]	family:[, social]	
#PasseSanitaire	sanitaire:[, solution]	passe:[, ref:passport, responsibilities]	
#NeverVoteCon	never:[, negation, rejecting]	con:[, distrust, rejecting]	vote:[, accepting]	
#SexWork	work:[, responsibilities]	
#NoGreenP	no:[, negation, rejecting]	green:[, ref:green, solution]	
#NoMand	no:[, negation, rejecting]	
#EvilBillGates	gates:[, personal, ref:bill_gates]	bill:[, political]	evil:[, ref:crime, rejecting]	
#StopTakin	stop:[, rejecting]	
#VaccineColonialism	vaccine:[, ref:vaccine, solution]	
#FreeEU	free:[, rights]	
#TeamCOVID	i:[, 1st, social]	team:[, accepting]	
#MyBodyMyCho	cho:[, personal]	body:[, social]	my:[, 1st, social]	
#BareShelvesBiden	biden:[, leftwing, personal, political, ref:biden, ref:democrats, social]	shelves:[, business]	
#DeBlasio	de:[, personal]	blasio:[, leftwing, personal, political, ref:bill_deblasio, ref:democrats]	
#VaccinObligatoire	vaccin:[, ref:vaccine, solution]	obligatoire:[, responsibilities]	
#EUGangsters	gangsters:[, rejecting]	
#NoTimeToDie	die:[, rejecting]	no:[, negation, rejecting]	time:[, time]	
#ForoNoVacunadosRD	no:[, negation, rejecting]	
#MassVaccination	vaccination:[, ref:vaccine, solution]	
#WarRoomShow	war:[, rejecting]	
#triesteNONmol	trieste:[, place, ref:austria]	
#DictatorBiden	biden:[, leftwing, personal, political, ref:biden, ref:democrats, social]	dictator:[, distrust, political, rejecting]	
#TogetherDe	de:[, personal]	together:[, social]	
#AldiBoycott	boycott:[, rejecting]	aldi:[, business]	
#SkyPalace	sky:[, place, ref:nature]	
#MakeAmericaTrumpAgain	trump:[, personal, political, ref:donald_trump, ref:trump, rightwing, social]	make:[, accepting]	america:[, place, ref:america]	
#COVIDVaccines	vaccines:[, ref:vaccine, solution]	i:[, 1st, social]	
#BSCGemsAlert	alert:[, rejecting]	
#ComeOnEngland	england:[, place, ref:uk]	
#PoopyBiden	biden:[, leftwing, personal, political, ref:biden, ref:democrats, social]	poopy:[, rejecting]	
#IStandWithSouthwestEm	i:[, 1st, social]	stand:[, accepting]	
#ArrestFauci	arrest:[, rejecting]	fauci:[, authority, personal, ref:fauci]	
#KeepTheFaith	keep:[, accepting]	faith:[, religious]	
#ResistanceIsVictory	victory:[, accepting]	is:[, opinionated]	resistance:[, rejecting]	
#ChildAbuse	abuse:[, rejecting]	child:[, social]	
#JimJordan	jordan:[, personal]	jim:[, personal]	
#DonotComply	comply:[, accepting, responsibilities]	donot:[, negation, rejecting]	
#NonAuPasseDeL	de:[, personal]	au:[, place, ref:australia]	passe:[, ref:passport, responsibilities]	
#CarbonCon	con:[, distrust, rejecting]	carbon:[, problem, ref:carbon, ref:nature]	
#NoJabsForJobs	no:[, negation, rejecting]	jobs:[, business]	for:[, accepting]	jabs:[, ref:vaccine, solution]	
#OhHellNo	no:[, negation, rejecting]	hell:[, rejecting]	
#StopTheVaccineRollout	vaccine:[, ref:vaccine, solution]	stop:[, rejecting]	
#GodWins	wins:[, accepting]	god:[, religious]	
#DigitalCertificate	digital:[, solution]	certificate:[, responsibilities, solution]	
#CallAction	action:[, accepting]	
#EstherRantzen	esther:[, personal]	
#whiteSupremacy	white:[, racial]	
#KidsVaccine	vaccine:[, ref:vaccine, solution]	kids:[, social]	
#StrongerTogether	stronger:[, accepting]	together:[, social]	
#NoManda	no:[, negation, rejecting]	
#BuyChapmans	chapmans:[, personal]	
#GodBlessTexas	texas:[, place, ref:america, ref:texas]	bless:[, accepting]	god:[, religious]	
#NoVaccinePassExtension	no:[, negation, rejecting]	vaccine:[, ref:vaccine, solution]	pass:[, ref:passport, responsibilities]	
#NoVaccineForMe	no:[, negation, rejecting]	vaccine:[, ref:vaccine, solution]	me:[, social]	for:[, accepting]	
#VaxChamp	champ:[, accepting]	vax:[, ref:vaccine, solution]	
#DementiaJoe	joe:[, leftwing, personal, political, ref:biden, ref:democrats]	dementia:[, problem, ref:illness]	
#MedicalDiscrimination	medical:[, authority, scientific]	discrimination:[, racial]	
#LeaveOurDNAalone	leave:[, rejecting]	our:[, 1st, social]	
#StandTheHellUp	stand:[, accepting]	hell:[, rejecting]	
#MedicalRape	rape:[, ref:crime, rejecting]	medical:[, authority, scientific]	
#NoForcedVaccination	no:[, negation, rejecting]	forced:[, rejecting]	vaccination:[, ref:vaccine, solution]	
#UnsafeSchools	unsafe:[, rejecting]	
#TheGreatGlob	great:[, accepting]	
#deBlasio	de:[, personal]	blasio:[, leftwing, personal, political, ref:bill_deblasio, ref:democrats]	
#ItsNotAboutHealth	not:[, negation, rejecting]	health:[, rights]	
#BoosterVaccine	vaccine:[, ref:vaccine, solution]	booster:[, ref:vaccine, solution]	
#PfizerLeak	leak:[, information]	pfizer:[, authority, business, ref:pfizer, ref:pharma]	
#AmericaFirst	america:[, place, ref:america]	
#EnoughIsEno	is:[, opinionated]	
#WeWillRememberThem	remember:[, accepting]	will:[, time]	them:[, 3rd, social]	we:[, 1st, social]	
#StandWithYou	stand:[, accepting]	you:[, 2nd, social]	
#UrsulaVaccinadator	ursula:[, personal]	
#DefundTheBBC	defund:[, rejecting]	
#EUFail	fail:[, rejecting]	
#IGotBoosted	i:[, 1st, social]	boosted:[, solution]	
#NoVaccineDiscrimination	no:[, negation, rejecting]	vaccine:[, ref:vaccine, solution]	discrimination:[, racial]	
#NoDiscrimination	no:[, negation, rejecting]	discrimination:[, racial]	
#NoTesting	no:[, negation, rejecting]	testing:[, solution]	
#SocialCreditScore	social:[, social]	credit:[, accepting, business]	
#DrDeathHinshaw	hinshaw:[, personal]	death:[, problem]	dr:[, authority]	
#NOVaccineMandate	mandate:[, responsibilities]	vaccine:[, ref:vaccine, solution]	
#LabLeak	leak:[, information]	lab:[, leftwing, political]	
#COVIDvaccines	i:[, 1st, social]	
#TogetherDeclarat	together:[, social]	
#CovidCult	covid:[, problem, ref:covid]	cult:[, distrust, rejecting]	
#FreeBelgium	free:[, rights]	belgium:[, place, ref:belgium]	
#CovidVaccinesideeffects	covid:[, problem, ref:covid]	
#JustSayNo#DoNotComply	no:[, negation, rejecting]	not:[, negation, rejecting]	comply:[, accepting, responsibilities]	do:[, accepting]	
#PandemieEnde	pandemie:[, problem, ref:illness]	
#OpenForAll	for:[, accepting]	open:[, accepting]	
#NoNHSMandate	no:[, negation, rejecting]	mandate:[, responsibilities]	
#ItsNotaVaccine	vaccine:[, ref:vaccine, solution]	
#RejectNWO	reject:[, rejecting]	
#FucktheGreatReset	reset:[, rejecting]	great:[, accepting]	
#ChoiceYo	choice:[, rights]	
#TravisTritt	travis:[, place]	
#CovidVaccinatio	covid:[, problem, ref:covid]	
#PremeditatedGenocide	genocide:[, ref:crime, rejecting]	
#PainChampion	pain:[, problem]	champion:[, accepting]	
#MarilynGladue	marilyn:[, personal]	
#CreepyJoe	joe:[, leftwing, personal, political, ref:biden, ref:democrats]	creepy:[, rejecting]	
#GlobalGoverment	goverment:[, authority]	global:[, place]	
#CovidVaccineinjury	covid:[, problem, ref:covid]	
#DefundCBC	defund:[, rejecting]	
#ForYourHealth	for:[, accepting]	health:[, rights]	your:[, 2nd, social]	
#TrudeauDictatorship	trudeau:[, leftwing, personal, political, ref:trudeau, social]	dictatorship:[, distrust, political, rejecting]	
#WarRoomPandemic	war:[, rejecting]	pandemic:[, problem, ref:illness]	
#PsychoPath	psycho:[, rejecting]	
#CovidUK	covid:[, problem, ref:covid]	
#UnitedWeWin	united:[, accepting]	win:[, accepting]	we:[, 1st, social]	
#AboriginalHumanRights	rights:[, rights]	aboriginal:[, place, ref:australia]	human:[, social]	
#ShadowGovernments	shadow:[, rejecting]	governments:[, authority, political]	
#JohnsonVariant	variant:[, problem, ref:illness]	johnson:[, personal, political, ref:boris_johnson, rightwing, social]	
#WeAreStillBeingLiedTo	are:[, opinionated]	lied:[, distrust, rejecting]	we:[, 1st, social]	
#GoldSilverCurrency	currency:[, business]	
#WeDoNo	no:[, negation, rejecting]	do:[, accepting]	we:[, 1st, social]	
#PublicHealth	public:[, social]	health:[, rights]	
#ItalianPM	italian:[, place, ref:italy]	
#PassSanitaire	pass:[, ref:passport, responsibilities]	sanitaire:[, solution]	
#MandateNotALaw	not:[, negation, rejecting]	mandate:[, responsibilities]	law:[, authority]	
#OmicronVarient	omicron:[, problem, ref:illness]	varient:[, problem, ref:illness]	
#NomandatoryVaccines	vaccines:[, ref:vaccine, solution]	
#ShameOnYouBorisJohnson	shame:[, rejecting]	boris:[, personal, political, ref:boris_johnson, rightwing, social]	johnson:[, personal, political, ref:boris_johnson, rightwing, social]	you:[, 2nd, social]	
#TheEnd	end:[, rejecting]	
#JustinTrudeau	trudeau:[, leftwing, personal, political, ref:trudeau, social]	
#AntiVaccine	vaccine:[, ref:vaccine, solution]	anti:[, rejecting]	
#FreedomLovers	freedom:[, rights]	lovers:[, accepting]	
#StayHome	home:[, social]	stay:[, accepting]	
#ImWithCOVID	im:[, 1st, social]	i:[, 1st, social]	
#DefundTheMandates	defund:[, rejecting]	mandates:[, responsibilities]	
#TorySleaze	tory:[, political, rightwing]	sleaze:[, distrust, rejecting]	
#NoCovidTyranny	no:[, negation, rejecting]	covid:[, problem, ref:covid]	tyranny:[, distrust, rejecting]	
#GregReese	greg:[, personal]	
#MaskofTheBeast	beast:[, animal, rejecting]	
#DreamteamLowLands	dreamteam:[, social]	lands:[, place]	
#BadFirefighters	bad:[, rejecting]	
#DefyMandates	defy:[, rejecting]	mandates:[, responsibilities]	
#KristaFord	krista:[, personal]	ford:[, business, personal]	
#ProtectYourFreedom	freedom:[, rights]	your:[, 2nd, social]	protect:[, accepting]	
#CovidVa	covid:[, problem, ref:covid]	
#OpenUp	open:[, accepting]	
#FreedomDecl	freedom:[, rights]	
#WeDontNeedTheUN	dont:[, negation, rejecting]	we:[, 1st, social]	
#ReInstateBernie	bernie:[, leftwing, personal, political, ref:bernie_sanders, ref:democrats]	
#AgeOfCorruption	corruption:[, distrust, rejecting]	age:[, time]	
#CancerCenter	cancer:[, problem, ref:illness]	
#PennyDropped	dropped:[, rejecting]	
#DoNotConsent	not:[, negation, rejecting]	do:[, accepting]	consent:[, rights]	
#NoPCRTesting	no:[, negation, rejecting]	testing:[, solution]	
#OntarioFi	ontario:[, place, ref:canada]	
#RichardRowe	richard:[, personal]	
#GreenpassObbligatorio	obbligatorio:[, responsibilities]	
#MakeCourageTheVirus	virus:[, problem, ref:illness]	make:[, accepting]	courage:[, accepting]	
#BreakingNews	news:[, information, ref:media]	breaking:[, rejecting]	
#EndEmergencyPowers	emergency:[, problem]	end:[, rejecting]	powers:[, authority]	
##NoVaccinePassports	no:[, negation, rejecting]	vaccine:[, ref:vaccine, solution]	passports:[, ref:passport, responsibilities]	
#DisasterPolitics	politics:[, political]	disaster:[, problem, ref:nature]	
#HarryStyles	harry:[, personal]	styles:[, time]	
#KangarooCourtofAustralia	australia:[, place, ref:australia]	
#CristianTerhes	cristian:[, personal]	
#DublinProtest	dublin:[, place, ref:ireland]	protest:[, rejecting]	
#LiberalLogic	logic:[, accepting, scientific]	liberal:[, leftwing, political]	
#DoNOTComply	comply:[, accepting, responsibilities]	do:[, accepting]	
#AstridStuckelberger	astrid:[, personal]	
#ScottishGovernment	government:[, authority]	scottish:[, place, ref:scotland]	
#LawAndOrder	law:[, authority]	
#ConcentrationCamps	camps:[, place, rejecting]	
#UnitedNo	no:[, negation, rejecting]	united:[, accepting]	
#StopTheJab	stop:[, rejecting]	jab:[, ref:vaccine, solution]	
#DemocratsDeliver	democrats:[, leftwing, political, ref:democrats]	deliver:[, accepting]	
#NoMedicalA	no:[, negation, rejecting]	medical:[, authority, scientific]	
#TheyWillNotDivideUs	not:[, negation, rejecting]	will:[, time]	divide:[, rejecting]	us:[, social]	they:[, 3rd, social]	
#VaccinesNotLaw	not:[, negation, rejecting]	law:[, authority]	vaccines:[, ref:vaccine, solution]	
#DeleteTheApp	delete:[, rejecting]	
#DoNotComplyEver	not:[, negation, rejecting]	comply:[, accepting, responsibilities]	do:[, accepting]	
#ImWithKyrie	im:[, 1st, social]	kyrie:[, personal]	
#UnitedKingdom	united:[, accepting]	kingdom:[, political]	
#MaskOFF	mask:[, ref:mask, solution]	
#RodgersResearch	rodgers:[, personal, ref:aaron_rodgers]	research:[, information, scientific]	
#FirePaulReid	fire:[, rejecting]	reid:[, personal]	paul:[, personal]	
#GBNews	news:[, information, ref:media]	
#StopTheVaccinePassports	vaccine:[, ref:vaccine, solution]	stop:[, rejecting]	passports:[, ref:passport, responsibilities]	
#DoNotStaySilent	silent:[, accepting]	not:[, negation, rejecting]	do:[, accepting]	stay:[, accepting]	
#PopeFrancis	pope:[, authority, religious]	francis:[, personal]	
#UnVaxxed	vaxxed:[, solution]	un:[, authority, political]	
#TheyAreFewWeAreMany	are:[, opinionated]	we:[, 1st, social]	they:[, 3rd, social]	
#RiseUpMelbourne	rise:[, rejecting]	melbourne:[, place, ref:australia]	
#NoDGC	no:[, negation, rejecting]	
#FreedomofChoice	choice:[, rights]	
#SajidJavidOut	sajid:[, personal, political, rightwing]	javid:[, personal]	
#ThankYouScience	science:[, authority, scientific]	thank:[, accepting]	you:[, 2nd, social]	
#ForcedQuarantine	forced:[, rejecting]	quarantine:[, solution]	
#InformationWar	war:[, rejecting]	information:[, information]	
#VaccinateTheWorld	vaccinate:[, ref:vaccine, solution]	world:[, place]	
#WeWill	will:[, time]	we:[, 1st, social]	
#NorthernTerritory	northern:[, place]	
#SoylentGreenNewDeal	deal:[, business]	green:[, ref:green, solution]	
#LeaveTheKidsAlone	leave:[, rejecting]	kids:[, social]	
#SovereignCitizens	sovereign:[, authority]	citizens:[, social]	
#CardiacArrest	arrest:[, rejecting]	
#JohnMurphy	murphy:[, personal]	john:[, personal]	
#NotJustAGreekLetter	greek:[, place, ref:greece]	not:[, negation, rejecting]	
#SydneyProtest	sydney:[, place, ref:australia]	protest:[, rejecting]	
#IsraeliApartheid	apartheid:[, political, racial, rejecting]	israeli:[, place]	
#FreshWomen	fresh:[, accepting]	women:[, social]	
#NoPan	no:[, negation, rejecting]	
#WarrenWilhelm	warren:[, personal]	
#CovidJab	covid:[, problem, ref:covid]	jab:[, ref:vaccine, solution]	
#NoPlanetB	no:[, negation, rejecting]	planet:[, place]	
#WhyAreTheyDoingThis	are:[, opinionated]	they:[, 3rd, social]	
#GetV	get:[, accepting]	
#MedicalAp	medical:[, authority, scientific]	
#CoronavirusUpdates	coronavirus:[, problem, ref:corona, ref:illness]	
#EndLockdownNow	now:[, time]	lockdown:[, responsibilities]	end:[, rejecting]	
#stopCoercion	stop:[, rejecting]	coercion:[, rejecting]	
#SayNoToCommunism	no:[, negation, rejecting]	communism:[, leftwing, political]	
#FreedomRaly	freedom:[, rights]	
#PlagueSpreaders	spreaders:[, problem, ref:illness]	plague:[, problem, ref:illness]	
#DrPredragKon	dr:[, authority]	
#TeamSurrender	team:[, accepting]	surrender:[, rejecting]	
#BlueLivesMatter	lives:[, social]	blue:[, leftwing, political]	
#VaccinePasspor	vaccine:[, ref:vaccine, solution]	
#LeaveOurKidsAlo	leave:[, rejecting]	our:[, 1st, social]	kids:[, social]	
#ThisPivotalMoment	moment:[, time]	
#EndScamdemic	scamdemic:[, distrust, rejecting]	end:[, rejecting]	
#AngelaMerkel	angela:[, personal]	
#DemCast	dem:[, leftwing, political, ref:democrats]	
#TorySleazeParty	tory:[, political, rightwing]	party:[, political]	sleaze:[, distrust, rejecting]	
#BringBackTheFreeWorld	world:[, place]	free:[, rights]	
#NoPlanB	no:[, negation, rejecting]	
#DontVax	vax:[, ref:vaccine, solution]	dont:[, negation, rejecting]	
#vaccineSid	vaccine:[, ref:vaccine, solution]	
#TheNewWorldOrder	world:[, place]	
#CovidCabal	covid:[, problem, ref:covid]	cabal:[, distrust, rejecting]	
#CovidPanto	panto:[, time]	covid:[, problem, ref:covid]	
#DrEvil	evil:[, ref:crime, rejecting]	dr:[, authority]	
#NaziDorsey	nazi:[, distrust, ref:fascism, rejecting]	dorsey:[, business, leftwing, personal, ref:jack_dorset]	
#HaraldWalach	harald:[, personal]	
#VoteConservative	conservative:[, political, rightwing]	vote:[, accepting]	
#LoveC	love:[, accepting]	
#LetGoBrandon	brandon:[, personal, political, rightwing]	go:[, accepting]	let:[, accepting]	
#IStandWithCarers	i:[, 1st, social]	stand:[, accepting]	
#NoMedicalApartheid	no:[, negation, rejecting]	medical:[, authority, scientific]	apartheid:[, political, racial, rejecting]	
#CivilRights	rights:[, rights]	civil:[, social]	
#DemocracyIsDead	dead:[, problem]	is:[, opinionated]	democracy:[, political, ref:democracy]	
#GeriatricGenX	gen:[, time]	
#WorldFreedomRally	world:[, place]	freedom:[, rights]	rally:[, accepting]	
#ZeroCovid	zero:[, rejecting]	covid:[, problem, ref:covid]	
#ChildrenDay	children:[, social]	day:[, time]	
#SaveAustralia	save:[, accepting]	australia:[, place, ref:australia]	
#CyrilRamaphosa	ramaphosa:[, personal, political, ref:africa]	cyril:[, personal]	
#ImpeachBidenNow	biden:[, leftwing, personal, political, ref:biden, ref:democrats, social]	impeach:[, rejecting]	now:[, time]	
#SwissReferendum	swiss:[, place, ref:switzerland]	referendum:[, political]	
#ChristianErickson	christian:[, religious]	
#TeamHalo	team:[, accepting]	halo:[, accepting]	
#NoMasksInClass	no:[, negation, rejecting]	masks:[, ref:mask, solution]	
#ResignJacind	resign:[, rejecting]	
#TripleVaxxed	vaxxed:[, solution]	
#WeDoNotConsent	not:[, negation, rejecting]	do:[, accepting]	consent:[, rights]	we:[, 1st, social]	
#NoGre	no:[, negation, rejecting]	
#DansNext	next:[, time]	
#PlagueSpreader	spreader:[, rejecting]	plague:[, problem, ref:illness]	
#ProudNotToBeBrainwashed	brainwashed:[, distrust, rejecting]	not:[, negation, rejecting]	be:[, accepting]	proud:[, accepting]	
#IBACDan	dan:[, personal]	i:[, 1st, social]	
#SayNo	no:[, negation, rejecting]	
#UniteWorldwide	unite:[, social]	
#IWillN	will:[, time]	i:[, 1st, social]	
#WhiteSupremacist	white:[, racial]	
#BillGates	gates:[, personal, ref:bill_gates]	bill:[, political]	
#ColinPowell	colin:[, personal]	powell:[, personal, political, ref:colin_powell]	
#FetchYourBody	your:[, 2nd, social]	body:[, social]	
#TestingNotLaw	not:[, negation, rejecting]	law:[, authority]	testing:[, solution]	
#PfizerExposed	exposed:[, rejecting]	pfizer:[, authority, business, ref:pfizer, ref:pharma]	
#NOCovidVaccineForChildren	vaccine:[, ref:vaccine, solution]	covid:[, problem, ref:covid]	children:[, social]	for:[, accepting]	
#BoostedBaybee	boosted:[, solution]	
#LestWeForget	forget:[, rejecting]	we:[, 1st, social]	
#BeConsiderate	be:[, accepting]	considerate:[, accepting]	
#BogusVaccine	bogus:[, distrust, rejecting]	vaccine:[, ref:vaccine, solution]	
#DavidIcke	david:[, personal]	
#FreedomOverFear	freedom:[, rights]	fear:[, rejecting]	
#FreedomIsEverything	freedom:[, rights]	is:[, opinionated]	
#SaveSport	save:[, accepting]	
#StopTheShots	stop:[, rejecting]	shots:[, ref:vaccine, solution]	
#EmptyShelvesJoe	joe:[, leftwing, personal, political, ref:biden, ref:democrats]	shelves:[, business]	empty:[, rejecting]	
#NoVaccinePassp	no:[, negation, rejecting]	vaccine:[, ref:vaccine, solution]	
#NaturallyImmunity	immunity:[, solution]	
#ImACelebrity	celebrity:[, accepting]	im:[, 1st, social]	
#CovidIsNotOver	not:[, negation, rejecting]	covid:[, problem, ref:covid]	is:[, opinionated]	
#DeepState	state:[, place]	
#UnitedStatesOfAmerica	united:[, accepting]	america:[, place, ref:america]	states:[, place]	
#NoVaccinePasspor	no:[, negation, rejecting]	vaccine:[, ref:vaccine, solution]	
#NewVariant	variant:[, problem, ref:illness]	
#TrustMe	trust:[, accepting]	me:[, social]	
#RonDeSantis	de:[, personal]	santis:[, personal, ref:ron_desantis]	
#COVIDvaccine	i:[, 1st, social]	
#NYCMayor	mayor:[, political]	
#CriticalRaceTheory	race:[, racial]	critical:[, rejecting]	theory:[, information, scientific]	
#TheGreatAwaking	great:[, accepting]	
#NOVaccineMandates	vaccine:[, ref:vaccine, solution]	mandates:[, responsibilities]	
#JeffreyEpstein	epstein:[, personal]	jeffrey:[, personal]	
#StoptheMandates	mandates:[, responsibilities]	
#LegalFiction	fiction:[, distrust, rejecting]	legal:[, authority]	
#GlobalCrisis	crisis:[, problem]	global:[, place]	
#ValueLife	value:[, business]	life:[, rights]	
#WakeUpNow	now:[, time]	
#MediaLies	lies:[, distrust, information, rejecting]	media:[, information, ref:media]	
#IgnoreThem	ignore:[, rejecting]	them:[, 3rd, social]	
#ndAm	am:[, opinionated]	
#VeteransDay	veterans:[, social]	day:[, time]	
#SayYesToFreedoms	yes:[, accepting]	freedoms:[, rights]	
#MasksNotLaw	not:[, negation, rejecting]	law:[, authority]	masks:[, ref:mask, solution]	
#LetsGoBran	go:[, accepting]	lets:[, accepting]	
#FauciLiedMillionsDied	millions:[, numeric]	died:[, problem]	fauci:[, authority, personal, ref:fauci]	lied:[, distrust, rejecting]	
#WeDoNotConsen	not:[, negation, rejecting]	do:[, accepting]	we:[, 1st, social]	
#LetsGoBiden	biden:[, leftwing, personal, political, ref:biden, ref:democrats, social]	go:[, accepting]	lets:[, accepting]	
#NoJabNoJob	no:[, negation, rejecting]	jab:[, ref:vaccine, solution]	job:[, business]	
#StaceyAbrams	stacey:[, personal]	
#NonAuPas	au:[, place, ref:australia]	
#LongIsland	island:[, place]	
#SaveOurChi	save:[, accepting]	our:[, 1st, social]	
#TampaGeneral	general:[, authority]	tampa:[, place, ref:america, ref:florida]	
#OmicronVariant	omicron:[, problem, ref:illness]	variant:[, problem, ref:illness]	
#UnitedNonCompliance	united:[, accepting]	compliance:[, responsibilities]	
#ScumVillainSelfSavingSystem	saving:[, accepting]	villain:[, rejecting]	self:[, social]	scum:[, rejecting]	
#standFirm	firm:[, business]	stand:[, accepting]	
#VaccineAdverseReactions	vaccine:[, ref:vaccine, solution]	adverse:[, problem]	
#CrimeAgainstHumanity	against:[, rejecting]	crime:[, ref:crime, rejecting]	humanity:[, social]	
#ProtectYourChildren	children:[, social]	your:[, 2nd, social]	protect:[, accepting]	
#vaccineDeaths	vaccine:[, ref:vaccine, solution]	deaths:[, problem]	
#MyShotHasBullets	my:[, 1st, social]	shot:[, ref:vaccine, solution]	
#NoVa	no:[, negation, rejecting]	
#StopCoer	stop:[, rejecting]	
#BernieWON	bernie:[, leftwing, personal, political, ref:bernie_sanders, ref:democrats]	
#AmericanAirlines	airlines:[, business]	american:[, place, ref:america]	
#HateDivides	hate:[, rejecting]	
#ProLife	pro:[, accepting]	life:[, rights]	
#CommunistCanada	communist:[, leftwing, political]	canada:[, place, ref:canada]	
#VaccinesAll	vaccines:[, ref:vaccine, solution]	
#ArrestMichaelMartin	michael:[, personal]	arrest:[, rejecting]	martin:[, personal]	
#GoonSquad	squad:[, social]	
#SanFrancisco	san:[, place]	
#CommonSense	common:[, social]	
#VaxExposed	exposed:[, rejecting]	vax:[, ref:vaccine, solution]	
#TorySleeze	tory:[, political, rightwing]	sleeze:[, rejecting]	
#GreatAwakening	awakening:[, accepting]	great:[, accepting]	
#CovidAss	ass:[, rejecting, vulgar]	covid:[, problem, ref:covid]	
#XiVariant	xi:[, leftwing, personal, political, ref:china, ref:xi]	variant:[, problem, ref:illness]	
#StopComplying	stop:[, rejecting]	complying:[, accepting]	
#AustralianOpen	australian:[, place, ref:australia]	open:[, accepting]	
#VaccinAction	vaccin:[, ref:vaccine, solution]	action:[, accepting]	
#DancingNurses	dancing:[, social]	nurses:[, solution]	
#WeWillAllBeTher	be:[, accepting]	will:[, time]	we:[, 1st, social]	
#MyChildMyChoice	choice:[, rights]	my:[, 1st, social]	child:[, social]	
#PeopleHoldThePower	power:[, authority]	people:[, social]	
#BankOfCanada	bank:[, business]	canada:[, place, ref:canada]	
#RejectNaziCovidVaxPass	nazi:[, distrust, ref:fascism, rejecting]	covid:[, problem, ref:covid]	pass:[, ref:passport, responsibilities]	reject:[, rejecting]	vax:[, ref:vaccine, solution]	
#NotSafeorEffective	effective:[, accepting]	not:[, negation, rejecting]	
#StopCOVIDDeaths	stop:[, rejecting]	i:[, 1st, social]	deaths:[, problem]	
#JohnWaters	john:[, personal]	
#VariantScam	variant:[, problem, ref:illness]	scam:[, distrust, rejecting]	
#OmicronInIndia	omicron:[, problem, ref:illness]	india:[, place, ref:india]	
#RemoveSage	sage:[, authority]	remove:[, rejecting]	
#VariantsAreBullshiiiit	are:[, opinionated]	variants:[, problem, ref:illness]	
#ProtectTheChildren	children:[, social]	protect:[, accepting]	
#StandYourGround	your:[, 2nd, social]	stand:[, accepting]	
#JustSayNo	no:[, negation, rejecting]	
#standToGether	stand:[, accepting]	
#FreeUs	free:[, rights]	us:[, social]	
#TheyreMockingUs	theyre:[, 3rd, social]	us:[, social]	mocking:[, rejecting]	
#TriumphofMary	mary:[, personal]	
#FreedomNOW	freedom:[, rights]	
#IrishGove	gove:[, personal, political, rightwing]	irish:[, place, ref:ireland]	
#MonstrousMonday	monstrous:[, rejecting]	monday:[, time]	
#NoMedi	no:[, negation, rejecting]	
#IDoNotConsent	not:[, negation, rejecting]	i:[, 1st, social]	do:[, accepting]	consent:[, rights]	
#NoVaccineMa	no:[, negation, rejecting]	vaccine:[, ref:vaccine, solution]	ma:[, social]	
#GoAustraliaGo	go:[, accepting]	australia:[, place, ref:australia]	
#BanCovidVax	covid:[, problem, ref:covid]	vax:[, ref:vaccine, solution]	ban:[, rejecting]	
#MengeleMandates	mengele:[, personal, ref:fascism, rejecting, scientific]	mandates:[, responsibilities]	
#NoToVaccinePassports	no:[, negation, rejecting]	vaccine:[, ref:vaccine, solution]	passports:[, ref:passport, responsibilities]	
#BoycottAldi	boycott:[, rejecting]	aldi:[, business]	
#ThisIsOurShot	is:[, opinionated]	our:[, 1st, social]	shot:[, ref:vaccine, solution]	
#IrreversibleRoadmap	irreversible:[, rejecting]	roadmap:[, information]	
#FreedomOfSpeech	freedom:[, rights]	
#TakeBackYourPower	take:[, accepting]	power:[, authority]	your:[, 2nd, social]	
#TedrosAdhanom	tedros:[, authority, personal]	
#SaveAmerica	save:[, accepting]	america:[, place, ref:america]	
#FauciForPrison	for:[, accepting]	fauci:[, authority, personal, ref:fauci]	prison:[, ref:crime, rejecting]	
#WelshProtesters	protesters:[, rejecting]	welsh:[, place, ref:wales]	
#RuralHealth	rural:[, place]	health:[, rights]	
#arrestBillGates	gates:[, personal, ref:bill_gates]	arrest:[, rejecting]	bill:[, political]	
#GlobalFraud	fraud:[, distrust, ref:crime, rejecting]	global:[, place]	
#ThisEndsWhenYouSayItDoes	when:[, time]	you:[, 2nd, social]	
#ReinstateDarrenPlymouth	reinstate:[, accepting]	plymouth:[, place]	
#MarchForFreedom	freedom:[, rights]	for:[, accepting]	
#CovidVaccineVictims	vaccine:[, ref:vaccine, solution]	covid:[, problem, ref:covid]	victims:[, problem]	
#LockHerUp	her:[, social]	
#BoosterShot	booster:[, ref:vaccine, solution]	shot:[, ref:vaccine, solution]	
#NoMoreSilence	no:[, negation, rejecting]	more:[, accepting]	silence:[, accepting]	
#NotInMyName	not:[, negation, rejecting]	name:[, social]	my:[, 1st, social]	
#VaccinesSave	vaccines:[, ref:vaccine, solution]	save:[, accepting]	
#ShoppersDougMart	doug:[, personal]	shoppers:[, business]	
#FordMustResign	must:[, responsibilities]	ford:[, business, personal]	resign:[, rejecting]	
#DougFord	doug:[, personal]	ford:[, business, personal]	
#DoomPorn	doom:[, problem]	porn:[, problem, ref:crime]	
#BurningTheMask	burning:[, rejecting]	mask:[, ref:mask, solution]	
#DeltaVariant	variant:[, problem, ref:illness]	delta:[, problem, ref:corona, ref:illness]	
#NoVaccineApartheid	no:[, negation, rejecting]	vaccine:[, ref:vaccine, solution]	apartheid:[, political, racial, rejecting]	
#conspiracyTheory	conspiracy:[, distrust, rejecting]	theory:[, information, scientific]	
#JoeRogan	joe:[, leftwing, personal, political, ref:biden, ref:democrats]	rogan:[, personal, ref:joe_rogan]	
#AustraliaProtests	protests:[, rejecting]	australia:[, place, ref:australia]	
#StrengthInNumbers	strength:[, accepting]	
#NoMoreFear	no:[, negation, rejecting]	more:[, accepting]	fear:[, rejecting]	
#OmnicronVariant	omnicron:[, problem, ref:illness]	variant:[, problem, ref:illness]	
#COVIDVaccineKids	vaccine:[, ref:vaccine, solution]	i:[, 1st, social]	kids:[, social]	
#PandemicOfSelfOverOthers	self:[, social]	pandemic:[, problem, ref:illness]	others:[, social]	
#UnitedAgainstVaxPassports	united:[, accepting]	against:[, rejecting]	passports:[, ref:passport, responsibilities]	vax:[, ref:vaccine, solution]	
#CrashTheSystem	crash:[, rejecting]	
#NoVaccineMandat	no:[, negation, rejecting]	vaccine:[, ref:vaccine, solution]	
#DigitalCurrency	digital:[, solution]	currency:[, business]	
#SackMichie	sack:[, rejecting]	michie:[, personal]	
#LetsGoBrandon	brandon:[, personal, political, rightwing]	go:[, accepting]	lets:[, accepting]	
#reinstateDarrenofPlymouth	reinstate:[, accepting]	plymouth:[, place]	
#MasksDoNotWork	not:[, negation, rejecting]	work:[, responsibilities]	masks:[, ref:mask, solution]	do:[, accepting]	
#AskNotorious	notorious:[, rejecting]	
#PCRtestFraud	fraud:[, distrust, ref:crime, rejecting]	
#DonLemon	don:[, personal]	
#NoPass	no:[, negation, rejecting]	pass:[, ref:passport, responsibilities]	
#NoGreenPass	no:[, negation, rejecting]	green:[, ref:green, solution]	pass:[, ref:passport, responsibilities]	
#NoMoreSesemeStreet	no:[, negation, rejecting]	street:[, place]	more:[, accepting]	
#COINversation	i:[, 1st, social]	
#DeprogramYourself	yourself:[, 2nd, social]	
#ArrestVallance	arrest:[, rejecting]	
#CovidWar	covid:[, problem, ref:covid]	war:[, rejecting]	
#MagdelenaAndersson	magdelena:[, personal]	
#FrenchPolynesia	french:[, place, ref:france]	
#CovidVariant	covid:[, problem, ref:covid]	variant:[, problem, ref:illness]	
#ConservativeCommunistParty	communist:[, leftwing, political]	conservative:[, political, rightwing]	party:[, political]	
#DisbandNphet	nphet:[, authority]	disband:[, rejecting]	
#ThePowerOfN	power:[, authority]	
#AustraliaHasFall	fall:[, rejecting]	australia:[, place, ref:australia]	
#NoVaccinePa	no:[, negation, rejecting]	vaccine:[, ref:vaccine, solution]	
#ShoppersDrugMart	shoppers:[, business]	
#IStandwithItaly	i:[, 1st, social]	standwith:[, accepting]	italy:[, place, ref:italy]	
#JavidOut	javid:[, personal]	
#PrayForAllLeaders	for:[, accepting]	leaders:[, authority]	pray:[, religious]	
#stopLying	stop:[, rejecting]	lying:[, distrust, rejecting]	
#ScotlandTheSlave	slave:[, racial, rejecting]	scotland:[, place, ref:scotland]	
#HealthR	health:[, rights]	
#PanNeverEndum	never:[, negation, rejecting]	
#GetVaccinatedASAP	get:[, accepting]	vaccinated:[, ref:vaccine, solution]	
#NiceTryPRguy	try:[, accepting]	nice:[, accepting]	
#NoVaccinPassports	vaccin:[, ref:vaccine, solution]	no:[, negation, rejecting]	passports:[, ref:passport, responsibilities]	
#CovidHOAX	covid:[, problem, ref:covid]	
#ProCOVID	i:[, 1st, social]	pro:[, accepting]	
#NuremburgCode	nuremburg:[, place, political, ref:nuremberg, rejecting]	
#SocialDistancing	social:[, social]	distancing:[, rejecting]	
#PoopyPants	poopy:[, rejecting]	
#PeaceGardens	peace:[, solution]	
#CivilDisobedience	disobedience:[, rejecting]	civil:[, social]	
#DevilsAdvocate	devils:[, rejecting, religious]	advocate:[, accepting]	
#MikeFisher	mike:[, personal]	
#NoShots	no:[, negation, rejecting]	shots:[, ref:vaccine, solution]	
#UnitednonCompliance	compliance:[, responsibilities]	
#ReinstateBernie	bernie:[, leftwing, personal, political, ref:bernie_sanders, ref:democrats]	reinstate:[, accepting]	
#VoteBlue	blue:[, leftwing, political]	vote:[, accepting]	
#QuarantineCamps	camps:[, place, rejecting]	quarantine:[, solution]	
#TraitorTrudeau	traitor:[, distrust, rejecting]	trudeau:[, leftwing, personal, political, ref:trudeau, social]	
#AnaCondYa	ya:[, social]	
#MikeAdams	mike:[, personal]	
#WearAFknNappy	wear:[, accepting]	
#WheresGavinNewsom	wheres:[, place]	gavin:[, leftwing, personal, political, ref:california, ref:democrats, ref:gavin_newsom]	newsom:[, leftwing, personal, political, ref:gavin_newsom]	
#ThanksBrandon	thanks:[, accepting]	brandon:[, personal, political, rightwing]	
#ChoiceNotUnemployment	not:[, negation, rejecting]	unemployment:[, problem]	choice:[, rights]	
#LatestNews	news:[, information, ref:media]	latest:[, time]	
#CovidWasAnInsideJob	covid:[, problem, ref:covid]	job:[, business]	inside:[, place]	
#DictatorDan	dan:[, personal]	dictator:[, distrust, political, rejecting]	
#DoD	do:[, accepting]	
#VoteEarly	vote:[, accepting]	early:[, time]	
#ProMengele	mengele:[, personal, ref:fascism, rejecting, scientific]	pro:[, accepting]	
#VaxBullies	bullies:[, rejecting]	vax:[, ref:vaccine, solution]	
#DictatureSanitaire	dictature:[, distrust, political, rejecting]	sanitaire:[, solution]	
#DoNotCo	not:[, negation, rejecting]	do:[, accepting]	co:[, problem, ref:carbon, ref:nature]	
#UsForThemUK	for:[, accepting]	them:[, 3rd, social]	us:[, social]	
#GetVa	get:[, accepting]	
#SaveOurChildren	children:[, social]	save:[, accepting]	our:[, 1st, social]	
#NoSocialCredit	no:[, negation, rejecting]	social:[, social]	credit:[, accepting, business]	
#HandsOffOurChildren	children:[, social]	our:[, 1st, social]	
#AntiClotshot	clotshot:[, problem, ref:illness, ref:vaccine, rejecting]	anti:[, rejecting]	
#FcukNphet	nphet:[, authority]	fcuk:[, rejecting, vulgar]	
#FauciLiedDogsDied	dogs:[, animal]	died:[, problem]	fauci:[, authority, personal, ref:fauci]	lied:[, distrust, rejecting]	
#SaveYourChildren	children:[, social]	save:[, accepting]	your:[, 2nd, social]	
#ChinaStyle	china:[, place, ref:china]	
#DrShillary	dr:[, authority]	
#VaxHa	vax:[, ref:vaccine, solution]	
#PerthFreedomMarch	freedom:[, rights]	perth:[, place, ref:australia]	
#MelbourneProte	melbourne:[, place, ref:australia]	
#VaccineAdverseEff	vaccine:[, ref:vaccine, solution]	eff:[, rejecting, vulgar]	adverse:[, problem]	
#StandAgainstFascism	against:[, rejecting]	fascism:[, distrust, ref:fascism, rejecting]	stand:[, accepting]	
#VaxandWin	win:[, accepting]	
#ItWa	wa:[, place]	
#ChrisWhitty	chris:[, personal]	whitty:[, authority, personal]	
#UnJabbed	jabbed:[, ref:vaccine, solution]	un:[, authority, political]	
#NoSegregation	no:[, negation, rejecting]	segregation:[, racial]	
#BelieveWom	believe:[, accepting]	
#BidenBoom	biden:[, leftwing, personal, political, ref:biden, ref:democrats, social]	boom:[, business]	
#ShameAndShun	shame:[, rejecting]	shun:[, rejecting]	
#DoN	do:[, accepting]	
#DnaHarvesting	dna:[, information, scientific]	
#SlavePassports	slave:[, racial, rejecting]	passports:[, ref:passport, responsibilities]	
#WeAreOneButWeAreMany	are:[, opinionated]	we:[, 1st, social]	
#NurembergCode	nuremberg:[, political, ref:nuremberg, rejecting]	
#LeaveTheKi	leave:[, rejecting]	
#SuperSpreader	spreader:[, rejecting]	
#SanitarySegregation	segregation:[, racial]	
#NoMedicalCoercion	no:[, negation, rejecting]	medical:[, authority, scientific]	coercion:[, rejecting]	
#UrsulavonderLeyen	ursulavonder:[, personal, political, ref:eu, ref:europe]	
#SteveBaker	steve:[, personal]	
#CovidVaccines	covid:[, problem, ref:covid]	vaccines:[, ref:vaccine, solution]	
#MyBod	my:[, 1st, social]	
#CrimesAg	crimes:[, problem, ref:crime, rejecting]	
#COVIDVaccineInjuries	vaccine:[, ref:vaccine, solution]	injuries:[, problem]	i:[, 1st, social]	
#NotInTheMoodForVaccinePa	vaccine:[, ref:vaccine, solution]	not:[, negation, rejecting]	for:[, accepting]	
#BorisUnfitPM	boris:[, personal, political, ref:boris_johnson, rightwing, social]	unfit:[, rejecting]	
#BloodCleanNoVaccine	no:[, negation, rejecting]	vaccine:[, ref:vaccine, solution]	clean:[, accepting]	
#HeartAndHustle	hustle:[, rejecting]	
#ClownWorld	world:[, place]	clown:[, rejecting]	
#BuildBackBette	bette:[, personal]	
#LetIrelandLive	let:[, accepting]	live:[, rights]	ireland:[, place, ref:ireland]	
#DictatorDans	dictator:[, distrust, political, rejecting]	
#CovidIdiots	covid:[, problem, ref:covid]	idiots:[, rejecting]	
#WeAreONE	are:[, opinionated]	we:[, 1st, social]	
#CivilWar	civil:[, social]	war:[, rejecting]	
#OpenDebate	debate:[, political]	open:[, accepting]	
#StopDansEnablingAct	enabling:[, accepting]	act:[, accepting]	stop:[, rejecting]	
#SayNoToVaccineMandate	no:[, negation, rejecting]	mandate:[, responsibilities]	vaccine:[, ref:vaccine, solution]	
#OmicronIsHere	omicron:[, problem, ref:illness]	is:[, opinionated]	
#UniteForFreedom	freedom:[, rights]	unite:[, social]	for:[, accepting]	
#ClownShow	clown:[, rejecting]	
#NoNewWorldOrder	no:[, negation, rejecting]	world:[, place]	
#GetBoostedNow	now:[, time]	get:[, accepting]	boosted:[, solution]	
#NurembergTrialsForCovid	covid:[, problem, ref:covid]	trials:[, scientific, solution]	nuremberg:[, political, ref:nuremberg, rejecting]	for:[, accepting]	
#VaccineMandate	mandate:[, responsibilities]	vaccine:[, ref:vaccine, solution]	
#NHSJabs	jabs:[, ref:vaccine, solution]	
#ArrestPatKenny	arrest:[, rejecting]	kenny:[, personal]	
#GordonBrown	gordon:[, personal]	
#PassofShame	shame:[, rejecting]	
#TheFinalSolution	solution:[, solution]	
#NoToMandat	no:[, negation, rejecting]	
#LondonProtest	london:[, place, ref:uk]	protest:[, rejecting]	
#AustrianPolice	police:[, authority]	austrian:[, place, ref:austria]	
#InfoWars	wars:[, problem]	info:[, information]	
#AntiVax	vax:[, ref:vaccine, solution]	anti:[, rejecting]	
#StopTheBullying	stop:[, rejecting]	bullying:[, rejecting]	
#SenatorAlexAntic	senator:[, political]	alex:[, personal]	
#GetCovidTested	covid:[, problem, ref:covid]	tested:[, solution]	get:[, accepting]	
#IWillNotCom	not:[, negation, rejecting]	will:[, time]	i:[, 1st, social]	
#FBRParty	party:[, political]	
#ClimateAction	action:[, accepting]	climate:[, problem, ref:climate, ref:nature]	
#WorldClassAthletes	world:[, place]	
#DoNotFear	not:[, negation, rejecting]	do:[, accepting]	fear:[, rejecting]	
#FraudNation	nation:[, place]	fraud:[, distrust, ref:crime, rejecting]	
#CrimesAgain	crimes:[, problem, ref:crime, rejecting]	
#HouseofLords	lords:[, authority, political]	
#PaidVaxPushers	paid:[, business]	pushers:[, ref:drugs, rejecting]	vax:[, ref:vaccine, solution]	
#EndPolio	end:[, rejecting]	polio:[, problem, ref:illness]	
#GreenpassObligatorio	obligatorio:[, responsibilities]	
#TacoTuesday	tuesday:[, time]	
#australianNurse	nurse:[, solution]	australian:[, place, ref:australia]	
#ResistNWO	resist:[, rejecting]	
#GhislaineMaxwellTria	maxwell:[, personal]	ghislaine:[, personal]	
#PostAMask	post:[, time]	mask:[, ref:mask, solution]	
#HandsOffKids	kids:[, social]	
#CoronavirusAct	act:[, accepting]	coronavirus:[, problem, ref:corona, ref:illness]	
#SocialDistance	distance:[, place]	social:[, social]	
#JoinTogether	join:[, accepting]	together:[, social]	
#CdnMediaFailed	failed:[, rejecting]	media:[, information, ref:media]	cdn:[, place, political]	
#MassivePlannedDepopulation	depopulation:[, rejecting]	
#NoToVaccineMandates	no:[, negation, rejecting]	vaccine:[, ref:vaccine, solution]	mandates:[, responsibilities]	
#JailSonjaTerstra	sonja:[, personal]	jail:[, ref:crime, rejecting]	
#LeamingtonSpa	leamington:[, place, ref:uk]	
#antiVaxxer	vaxxer:[, ref:vaccine, solution]	anti:[, rejecting]	
#ToryLiars	tory:[, political, rightwing]	liars:[, distrust, rejecting]	
#GlobalReset	reset:[, rejecting]	global:[, place]	
#NoToTyranny	no:[, negation, rejecting]	tyranny:[, distrust, rejecting]	
#PassTheBill	pass:[, ref:passport, responsibilities]	bill:[, political]	
#FightFlu	flu:[, problem, ref:illness]	fight:[, rejecting]	
#BioTerrorism	terrorism:[, ref:crime, rejecting]	bio:[, scientific]	
#NoVaccineMandate	no:[, negation, rejecting]	mandate:[, responsibilities]	vaccine:[, ref:vaccine, solution]	
#CDCIsBigPharma	is:[, opinionated]	pharma:[, business, ref:pharma]	
#EveningStandard	evening:[, time]	
#AshleyMoody	ashley:[, personal]	
#EndTheScam	scam:[, distrust, rejecting]	end:[, rejecting]	
#VaccineInjuries	vaccine:[, ref:vaccine, solution]	injuries:[, problem]	
#ArrestBoris	arrest:[, rejecting]	boris:[, personal, political, ref:boris_johnson, rightwing, social]	
#NHSCrisis	crisis:[, problem]	
#WheresGavin	wheres:[, place]	gavin:[, leftwing, personal, political, ref:california, ref:democrats, ref:gavin_newsom]	
#IvermectinForParasites	for:[, accepting]	parasites:[, animal, problem, ref:illness, rejecting]	ivermectin:[, ref:ivermectin, solution]	
#FakeBidenAdminisration	biden:[, leftwing, personal, political, ref:biden, ref:democrats, social]	adminisration:[, authority]	fake:[, distrust, rejecting]	
#BusinessModel	business:[, business]	model:[, scientific]	
#PeoplebeinginJected	peoplebeingin:[, social]	
#NoVaccineMandates	no:[, negation, rejecting]	vaccine:[, ref:vaccine, solution]	mandates:[, responsibilities]	
#StreetYouGrewUpOn	street:[, place]	you:[, 2nd, social]	
#ShameOnNaziAustria	nazi:[, distrust, ref:fascism, rejecting]	shame:[, rejecting]	austria:[, place, ref:austria]	
#StateFarm	farm:[, place]	state:[, place]	
#JohnsonTheLiar	liar:[, distrust, rejecting]	johnson:[, personal, political, ref:boris_johnson, rightwing, social]	
#COVIDAus	i:[, 1st, social]	aus:[, place, ref:australia]	
#MasksWork	work:[, responsibilities]	masks:[, ref:mask, solution]	
#NoMandator	no:[, negation, rejecting]	
#NoMandatoryMasks	no:[, negation, rejecting]	masks:[, ref:mask, solution]	mandatory:[, responsibilities]	
#CzechRepublic	republic:[, political]	czech:[, place]	
#NewBlueOntario	blue:[, leftwing, political]	ontario:[, place, ref:canada]	
#ClownPants	clown:[, rejecting]	
#NoCBDC	no:[, negation, rejecting]	
#GovernmentOverreach	government:[, authority]	overreach:[, rejecting]	
#ThrowAwayYourMasks	away:[, rejecting]	throw:[, rejecting]	masks:[, ref:mask, solution]	your:[, 2nd, social]	
#NationalCabinet	national:[, place]	cabinet:[, political]	
#ToriesOut	tories:[, political, ref:uk, rightwing]	
#FreedomInternet	freedom:[, rights]	
#gopDeathCult	cult:[, distrust, rejecting]	death:[, problem]	gop:[, political, ref:republicans, rightwing]	
#FearFactory	factory:[, business]	fear:[, rejecting]	
#JohnsonOut	johnson:[, personal, political, ref:boris_johnson, rightwing, social]	
#ToryShambles	tory:[, political, rightwing]	shambles:[, rejecting]	
#IStandWithCinemaCoSwansea	swansea:[, place, ref:uk, ref:wales]	i:[, 1st, social]	co:[, problem, ref:carbon, ref:nature]	stand:[, accepting]	
#VaccineFraud	vaccine:[, ref:vaccine, solution]	fraud:[, distrust, ref:crime, rejecting]	
#NoCovidPaSS	no:[, negation, rejecting]	covid:[, problem, ref:covid]	
#GlobalistPuppets	puppets:[, distrust, rejecting]	globalist:[, rejecting]	
#MedicalApartheid	medical:[, authority, scientific]	apartheid:[, political, racial, rejecting]	
#ConstitutionalViolation	constitutional:[, authority, political]	
#VaccineApa	vaccine:[, ref:vaccine, solution]	
#GeneTherapy	gene:[, information, scientific]	therapy:[, scientific, solution]	
#ArrestJacinda	jacinda:[, personal, ref:jacinda_ardern]	arrest:[, rejecting]	
#TheGreatGlobalPushb	global:[, place]	great:[, accepting]	
#SaveTheNHS	save:[, accepting]	
#FailedState	state:[, place]	failed:[, rejecting]	
#FinancialFreedom	freedom:[, rights]	financial:[, business]	
#SeekstHisKingdom	his:[, 3rd, social]	kingdom:[, political]	
#GodIsLove	love:[, accepting]	is:[, opinionated]	god:[, religious]	
#CovidFraud	covid:[, problem, ref:covid]	fraud:[, distrust, ref:crime, rejecting]	
#GetVaccina	get:[, accepting]	
#NotApproved	approved:[, accepting]	not:[, negation, rejecting]	
#NOVaccinePassportsAnywhere	vaccine:[, ref:vaccine, solution]	passports:[, ref:passport, responsibilities]	
#StandUnited	united:[, accepting]	stand:[, accepting]	
#NoToMandatoryVaccine	no:[, negation, rejecting]	vaccine:[, ref:vaccine, solution]	mandatory:[, responsibilities]	
#NoMedicalTyrranny	no:[, negation, rejecting]	medical:[, authority, scientific]	tyrranny:[, distrust, ref:fascism, rejecting]	
#LeaveOurChildrenAlone	children:[, social]	leave:[, rejecting]	our:[, 1st, social]	
#BackAlleyButchers	alley:[, place]	
#SpeakerPelosi	pelosi:[, leftwing, personal, political, ref:nancy_pelosi]	
#SocialCre	social:[, social]	
#PedsID	peds:[, rejecting]	i:[, 1st, social]	
#CovidCamp	covid:[, problem, ref:covid]	camp:[, place]	
#VaccineCertificates	vaccine:[, ref:vaccine, solution]	certificates:[, ref:passport, responsibilities, solution]	
#YellowCardScheme	scheme:[, distrust, rejecting]	
#ArrestMichie	arrest:[, rejecting]	michie:[, personal]	
#ImDone	im:[, 1st, social]	
#ThisRightHere	right:[, accepting]	
#WesternUniversity	university:[, place]	western:[, place]	
#FakeVaccine	vaccine:[, ref:vaccine, solution]	fake:[, distrust, rejecting]	
#NationwideShutdown	nationwide:[, place]	shutdown:[, rejecting]	
#ChrisTisKing	chris:[, personal]	king:[, authority]	
#NonAuPassDeLaHont	de:[, personal]	au:[, place, ref:australia]	la:[, place]	pass:[, ref:passport, responsibilities]	
#WeAre	are:[, opinionated]	we:[, 1st, social]	
#TaxChurches	tax:[, authority]	churches:[, religious]	
#WeResist	resist:[, rejecting]	we:[, 1st, social]	
#NoVaccinePassportsAny	no:[, negation, rejecting]	vaccine:[, ref:vaccine, solution]	passports:[, ref:passport, responsibilities]	
#sayNo	no:[, negation, rejecting]	
#NoDigitalID	digital:[, solution]	no:[, negation, rejecting]	i:[, 1st, social]	
#SaysNoToRyranny	no:[, negation, rejecting]	ryranny:[, distrust, political, rejecting]	
#TheEmperorsNewClothes	emperors:[, authority, rejecting]	
#GoAustralia	go:[, accepting]	australia:[, place, ref:australia]	
#DrHi	dr:[, authority]	
#SaturdayVibes	saturday:[, time]	
#FreeToFly	free:[, rights]	
#FreedomTogether	freedom:[, rights]	together:[, social]	
#KillerVaccines	vaccines:[, ref:vaccine, solution]	killer:[, ref:crime, rejecting]	
#WheresPete	wheres:[, place]	
#ResistFa	resist:[, rejecting]	
#FreeVictoria	victoria:[, place, ref:australia]	free:[, rights]	
#NoSocialCreditSystem	no:[, negation, rejecting]	social:[, social]	credit:[, accepting, business]	
#VaccineHolocaust	vaccine:[, ref:vaccine, solution]	holocaust:[, racial, rejecting, time]	
#LaGenteComeNoiNonMoll	la:[, place]	
#ChrisskyMallRant	rant:[, rejecting]	
#EndSARSMemorial	end:[, rejecting]	memorial:[, accepting]	
#LeaveTheUnitedNations	united:[, accepting]	leave:[, rejecting]	nations:[, place]	
#PandemicofVaccinated	vaccinated:[, ref:vaccine, solution]	
#GhislaineMaxwellTrial	maxwell:[, personal]	trial:[, scientific, solution]	ghislaine:[, personal]	
#RemembranceDay	day:[, time]	
#SNPBadForScotland	bad:[, rejecting]	for:[, accepting]	scotland:[, place, ref:scotland]	
#VirginiaElection	election:[, political]	virginia:[, place]	
#KilltheBill	bill:[, political]	
#GreatFinancialReset	financial:[, business]	reset:[, rejecting]	great:[, accepting]	
#LearnHistory	history:[, time]	
#MasksInSchool	school:[, place]	masks:[, ref:mask, solution]	
#SaveYourself	save:[, accepting]	yourself:[, 2nd, social]	
#JusticeForKartik	for:[, accepting]	justice:[, rights]	
#TongueOutTuesday	tuesday:[, time]	
#GetOffYourKnees	get:[, accepting]	your:[, 2nd, social]	
#VaxInjured	injured:[, problem]	vax:[, ref:vaccine, solution]	
#AlexanderShallenberg	alexander:[, personal]	
#ReInstateBerniesTweet	tweet:[, information, ref:media]	bernies:[, leftwing, personal, political, ref:bernie_sanders, ref:democrats]	
#SocialCreditSystem	social:[, social]	credit:[, accepting, business]	
#YouAreLivingALie	are:[, opinionated]	lie:[, distrust, rejecting]	you:[, 2nd, social]	
#AmericanRescuePlan	american:[, place, ref:america]	rescue:[, accepting]	
#WilliamsandSonoma	williamsand:[, personal]	
#BlueWarriors	blue:[, leftwing, political]	warriors:[, accepting]	
#MichelleNicoles	michelle:[, personal]	
#WeAreThePercent	are:[, opinionated]	we:[, 1st, social]	
#TorontoPolic	toronto:[, place, ref:canada]	
#NeverWearAMask	never:[, negation, rejecting]	wear:[, accepting]	mask:[, ref:mask, solution]	
#VaccineMand	vaccine:[, ref:vaccine, solution]	
#StopTheVaccine	vaccine:[, ref:vaccine, solution]	stop:[, rejecting]	
#NoDigitalPassports	digital:[, solution]	no:[, negation, rejecting]	passports:[, ref:passport, responsibilities]	
#StopThisNow	stop:[, rejecting]	now:[, time]	
#ClotShot	clot:[, problem, ref:illness]	shot:[, ref:vaccine, solution]	
#DoNotCom	not:[, negation, rejecting]	do:[, accepting]	
#ClwydWest	west:[, place]	
#ManifsNovembre	novembre:[, time]	
#LikeForever	forever:[, time]	
#TriesteResiste	trieste:[, place, ref:austria]	
#NoMandatoryVaccination	no:[, negation, rejecting]	mandatory:[, responsibilities]	vaccination:[, ref:vaccine, solution]	
#ScamdemicIsOver	scamdemic:[, distrust, rejecting]	is:[, opinionated]	
#SackDan	dan:[, personal]	sack:[, rejecting]	
#LiarFromTheShire	shire:[, place, ref:uk]	liar:[, distrust, rejecting]	
#MakeReady	make:[, accepting]	
#PaperMasksDontW	masks:[, ref:mask, solution]	dont:[, negation, rejecting]	
#NoID	no:[, negation, rejecting]	i:[, 1st, social]	
#FordFail	fail:[, rejecting]	ford:[, business, personal]	
#WeWillNotCompl	not:[, negation, rejecting]	will:[, time]	we:[, 1st, social]	
#LiarJohnson	johnson:[, personal, political, ref:boris_johnson, rightwing, social]	liar:[, distrust, rejecting]	
#EnoughIsEnough	is:[, opinionated]	
#BoosterShots	shots:[, ref:vaccine, solution]	booster:[, ref:vaccine, solution]	
#NoForcedLockdowns	lockdowns:[, responsibilities]	no:[, negation, rejecting]	forced:[, rejecting]	
#KidsRock	kids:[, social]	
#EndTryyany	tryyany:[, distrust, political, rejecting]	end:[, rejecting]	
#antiVaxxers	vaxxers:[, accepting, ref:vaccine, solution]	anti:[, rejecting]	
#BeStrongANDCourageous	strong:[, accepting]	be:[, accepting]	courageous:[, accepting]	
#NeverTrustJWR	trust:[, accepting]	never:[, negation, rejecting]	
#NovakDjokovic	novak:[, personal, ref:novak_djokovic]	djokovic:[, personal, ref:novak_djokovic]	
#FloydMayweather	floyd:[, personal]	
#NoGr	no:[, negation, rejecting]	
#FightForYourFreedom	freedom:[, rights]	for:[, accepting]	your:[, 2nd, social]	fight:[, rejecting]	
#CovidVaccine	vaccine:[, ref:vaccine, solution]	covid:[, problem, ref:covid]	
#CDNPoli	poli:[, political]	
#NoGreenPas	no:[, negation, rejecting]	green:[, ref:green, solution]	
#TyrannyInPlainSight	tyranny:[, distrust, rejecting]	
#MattHancock	hancock:[, personal]	matt:[, personal]	
#ArrestFau	arrest:[, rejecting]	
#HealthFreedom	freedom:[, rights]	health:[, rights]	
#WearAMask	wear:[, accepting]	mask:[, ref:mask, solution]	
#IstandWithTheCarers	istand:[, 1st]	
#ChinaVirus	china:[, place, ref:china]	virus:[, problem, ref:illness]	
#MoMoreLockdowns	lockdowns:[, responsibilities]	more:[, accepting]	
#BoycottMcDonalds	donalds:[, personal]	boycott:[, rejecting]	
#GislaineMaxwelltrial	gislaine:[, personal]	
#VaxxersRemorse	vaxxers:[, accepting, ref:vaccine, solution]	remorse:[, rejecting]	
#WeStandTogether	stand:[, accepting]	together:[, social]	we:[, 1st, social]	
#PaidVaxPusher	pusher:[, rejecting]	paid:[, business]	vax:[, ref:vaccine, solution]	
#JailF	jail:[, ref:crime, rejecting]	
#WeStandWithItaly	stand:[, accepting]	italy:[, place, ref:italy]	we:[, 1st, social]	
#TransportDay	transport:[, business]	day:[, time]	
#WeWin	win:[, accepting]	we:[, 1st, social]	
#VaccineInjuryRealNotRare	not:[, negation, rejecting]	vaccine:[, ref:vaccine, solution]	real:[, accepting]	injury:[, problem, ref:illness]	
#HoganTellsTheFansToShoveIt	hogan:[, personal]	fans:[, accepting]	
#WeWil	we:[, 1st, social]	
#CanYouSeeItNow	now:[, time]	you:[, 2nd, social]	
#StopGettingTested	getting:[, accepting]	stop:[, rejecting]	tested:[, solution]	
#ConspiracyFact	fact:[, information]	conspiracy:[, distrust, rejecting]	
#ProudNeverSleever	never:[, negation, rejecting]	proud:[, accepting]	
#GetVac	get:[, accepting]	
#MasksOff	masks:[, ref:mask, solution]	
#SpectorTheShill	shill:[, accepting]	spector:[, personal]	
#WeWillNotComp	not:[, negation, rejecting]	will:[, time]	we:[, 1st, social]	
#KyrieIrving	kyrie:[, personal]	
#DepopulationAgenda	depopulation:[, rejecting]	agenda:[, political]	
#FakeMayors	mayors:[, political]	fake:[, distrust, rejecting]	
#BillsMafia	mafia:[, problem, ref:crime]	
#NoToStateMandatedMedicine	no:[, negation, rejecting]	medicine:[, solution]	state:[, place]	mandated:[, responsibilities]	
#CoronaVaccines	vaccines:[, ref:vaccine, solution]	corona:[, problem, ref:corona, ref:illness]	
#NoMedicalTyran	no:[, negation, rejecting]	medical:[, authority, scientific]	
#RestInPeace	peace:[, solution]	
#NoVaccinepassports	no:[, negation, rejecting]	
#FridayFeeling	friday:[, time]	
#PassSanitair	pass:[, ref:passport, responsibilities]	
#SturgeonEffect	effect:[, problem]	sturgeon:[, personal, political, ref:nicola_sturgeon, ref:scotland]	
#ClimateGate	gate:[, distrust, political, rejecting]	climate:[, problem, ref:climate, ref:nature]	
#AlexJones	alex:[, personal]	
#BillGatesIsEvil	gates:[, personal, ref:bill_gates]	bill:[, political]	is:[, opinionated]	evil:[, ref:crime, rejecting]	
#GetVax	get:[, accepting]	vax:[, ref:vaccine, solution]	
#StopGovernmentOverreach	government:[, authority]	stop:[, rejecting]	overreach:[, rejecting]	
#TheJabMustBeStopped	stopped:[, rejecting]	be:[, accepting]	must:[, responsibilities]	jab:[, ref:vaccine, solution]	
#NoVaccinePassportsAnywhe	no:[, negation, rejecting]	vaccine:[, ref:vaccine, solution]	passports:[, ref:passport, responsibilities]	
#TrudeauworstPMever	trudeauworst:[, leftwing, personal, political, ref:trudeau, rejecting]	
#GetVaxxed	vaxxed:[, solution]	get:[, accepting]	
#NoCovidPassports	no:[, negation, rejecting]	covid:[, problem, ref:covid]	passports:[, ref:passport, responsibilities]	
#doNotComply	not:[, negation, rejecting]	comply:[, accepting, responsibilities]	do:[, accepting]	
#DoSomething	do:[, accepting]	
#NightTimeEconomy	night:[, time]	economy:[, business]	time:[, time]	
#ArrestGates	gates:[, personal, ref:bill_gates]	arrest:[, rejecting]	
#FauciLieAndPeopleDie	die:[, rejecting]	lie:[, distrust, rejecting]	fauci:[, authority, personal, ref:fauci]	people:[, social]	
#HousePfizer	pfizer:[, authority, business, ref:pfizer, ref:pharma]	house:[, place]	
#ReclaimTheLine	reclaim:[, accepting]	
#NonAuPassSanitaire	au:[, place, ref:australia]	pass:[, ref:passport, responsibilities]	sanitaire:[, solution]	
#JoeBiden	biden:[, leftwing, personal, political, ref:biden, ref:democrats, social]	joe:[, leftwing, personal, political, ref:biden, ref:democrats]	
#wewillALLbether	wewill:[, social]	
#MeeeeToooo	meeee:[, social]	
#CovidVaccineMandates	vaccine:[, ref:vaccine, solution]	covid:[, problem, ref:covid]	mandates:[, responsibilities]	
#NancyPelosi	nancy:[, personal]	pelosi:[, leftwing, personal, political, ref:nancy_pelosi]	
#BinTheMask	bin:[, rejecting]	mask:[, ref:mask, solution]	
#JesusChrist	christ:[, religious]	jesus:[, religious]	
#ArrestPaulReid	arrest:[, rejecting]	reid:[, personal]	paul:[, personal]	
#VaccineSafetyEnquiryNow	vaccine:[, ref:vaccine, solution]	safety:[, solution]	now:[, time]	
#OurGovernment	government:[, authority]	our:[, 1st, social]	
#QRCode	q:[, political, ref:q, rightwing]	
#ThisTooShallPass	pass:[, ref:passport, responsibilities]	
#MaskMandates	mandates:[, responsibilities]	mask:[, ref:mask, solution]	
#WeDoNotComply	not:[, negation, rejecting]	comply:[, accepting, responsibilities]	do:[, accepting]	we:[, 1st, social]	
#ScumMediaLiars	liars:[, distrust, rejecting]	media:[, information, ref:media]	scum:[, rejecting]	
#TrudeauIsTrash	trudeau:[, leftwing, personal, political, ref:trudeau, social]	is:[, opinionated]	trash:[, rejecting]	
#OpenFor	for:[, accepting]	open:[, accepting]	
#BrettSutton	brett:[, personal]	
#WhereIsDougFord	doug:[, personal]	is:[, opinionated]	ford:[, business, personal]	
#GhislaneMaxwell	ghislane:[, personal]	maxwell:[, personal]	
#ItIsAScam	scam:[, distrust, rejecting]	is:[, opinionated]	
#ResignHinshaw	hinshaw:[, personal]	resign:[, rejecting]	
#COVIDJab	i:[, 1st, social]	jab:[, ref:vaccine, solution]	
#AmericaSur	america:[, place, ref:america]	
#AlphabetSwamp	alphabet:[, business]	swamp:[, place, rejecting]	
#TrumpVirus	trump:[, personal, political, ref:donald_trump, ref:trump, rightwing, social]	virus:[, problem, ref:illness]	
#TheGreatReject	reject:[, rejecting]	great:[, accepting]	
#NoVaccine	no:[, negation, rejecting]	vaccine:[, ref:vaccine, solution]	
#FuckYouJoeBiden	biden:[, leftwing, personal, political, ref:biden, ref:democrats, social]	joe:[, leftwing, personal, political, ref:biden, ref:democrats]	fuck:[, rejecting, vulgar]	you:[, 2nd, social]	
#NaziAustria	nazi:[, distrust, ref:fascism, rejecting]	austria:[, place, ref:austria]	
#IrelandFreedomDay	freedom:[, rights]	day:[, time]	ireland:[, place, ref:ireland]	
#FauciLie	lie:[, distrust, rejecting]	fauci:[, authority, personal, ref:fauci]	
#GatesDevelopedMarkOfTheBeast	gates:[, personal, ref:bill_gates]	beast:[, animal, rejecting]	
#SayNoToVacci	no:[, negation, rejecting]	vacci:[, ref:vaccine, solution]	
#PfizerWhistleblower	whistleblower:[, information]	pfizer:[, authority, business, ref:pfizer, ref:pharma]	
#WeToldYouSo	you:[, 2nd, social]	we:[, 1st, social]	
#GatesOfHell	gates:[, personal, ref:bill_gates]	hell:[, rejecting]	
#NoMasks	no:[, negation, rejecting]	masks:[, ref:mask, solution]	
#NoMa	no:[, negation, rejecting]	ma:[, social]	
#NoMe	no:[, negation, rejecting]	me:[, social]	
#RandomActsOfNonCompliance	compliance:[, responsibilities]	
#NonAuPassSanitai	au:[, place, ref:australia]	pass:[, ref:passport, responsibilities]	
#FJoeBiden	biden:[, leftwing, personal, political, ref:biden, ref:democrats, social]	joe:[, leftwing, personal, political, ref:biden, ref:democrats]	
#NoLo	no:[, negation, rejecting]	
#VaccineScam	vaccine:[, ref:vaccine, solution]	scam:[, distrust, rejecting]	
#NoVaccinePassportsAn	no:[, negation, rejecting]	vaccine:[, ref:vaccine, solution]	passports:[, ref:passport, responsibilities]	
#FortStJohn	st:[, religious]	john:[, personal]	
#NoCovidID	no:[, negation, rejecting]	covid:[, problem, ref:covid]	i:[, 1st, social]	
#ProChoice	choice:[, rights]	pro:[, accepting]	
#NoVaccinePassportsAnyw	no:[, negation, rejecting]	vaccine:[, ref:vaccine, solution]	passports:[, ref:passport, responsibilities]	
#TimeToTakeBackWhatIsOurs	take:[, accepting]	ours:[, 1st]	is:[, opinionated]	time:[, time]	
#WeatherWeapons	weapons:[, solution]	
#WeCanRestoreTheOC	restore:[, accepting]	we:[, 1st, social]	
#NewZealanders	zealanders:[, place, ref:new_zealand]	
#BorisJohnson	boris:[, personal, political, ref:boris_johnson, rightwing, social]	johnson:[, personal, political, ref:boris_johnson, rightwing, social]	
#FreeToTravel	free:[, rights]	
#WakeTheFuckUp	fuck:[, rejecting, vulgar]	
#FreshVoicesRi	voices:[, information]	fresh:[, accepting]	
#RememberanceDay	day:[, time]	
#WeThePeopleMust	must:[, responsibilities]	people:[, social]	we:[, 1st, social]	
#GetBoosted	get:[, accepting]	boosted:[, solution]	
#RacistJoe	joe:[, leftwing, personal, political, ref:biden, ref:democrats]	racist:[, racial]	
#BidensAmerica	bidens:[, leftwing, personal, political, ref:biden, ref:democrats, social]	america:[, place, ref:america]	
#PassDeLaHonte	de:[, personal]	la:[, place]	pass:[, ref:passport, responsibilities]	
#ThrowbackThursday	thursday:[, time]	throwback:[, rejecting]	
#HealthcareFreedom	freedom:[, rights]	healthcare:[, solution]	
#IwillNOTComply	comply:[, accepting, responsibilities]	iwill:[, accepting]	
#MasksDontWork	work:[, responsibilities]	masks:[, ref:mask, solution]	dont:[, negation, rejecting]	
#DefendDemocracy	defend:[, accepting]	democracy:[, political, ref:democracy]	
#COPGlasgow	glasgow:[, place, ref:scotland]	
#QuarantineLife	quarantine:[, solution]	life:[, rights]	
#BloodOnHisHands	his:[, 3rd, social]	
#NoVaccinePasssports	no:[, negation, rejecting]	vaccine:[, ref:vaccine, solution]	passsports:[, ref:passport, responsibilities]	
#RemoveRon	remove:[, rejecting]	
#PedoJoes	pedo:[, rejecting]	
#NYTimes	times:[, time]	
#WuhanFlu	wuhan:[, place, ref:china]	flu:[, problem, ref:illness]	
#MassNonCompliance	compliance:[, responsibilities]	
#ResinstateSimonWard	simon:[, personal]	resinstate:[, accepting]	
#NoMoreLockd	no:[, negation, rejecting]	more:[, accepting]	
#StopTheTyranny	tyranny:[, distrust, rejecting]	stop:[, rejecting]	
#WestJet	west:[, place]	
#FauciGate	gate:[, distrust, political, rejecting]	fauci:[, authority, personal, ref:fauci]	
#FireKieranMoore	kieran:[, personal]	fire:[, rejecting]	
#GetBo	get:[, accepting]	
#NoNewNormal	no:[, negation, rejecting]	
#FollowTheScience	science:[, authority, scientific]	follow:[, accepting]	
#UnderTheInfluence	influence:[, authority]	
#fireFauci	fire:[, rejecting]	fauci:[, authority, personal, ref:fauci]	
#VaccineCertificate	vaccine:[, ref:vaccine, solution]	certificate:[, responsibilities, solution]	
#FakePandemic	fake:[, distrust, rejecting]	pandemic:[, problem, ref:illness]	
#COVIDCanada	canada:[, place, ref:canada]	i:[, 1st, social]	
#COVIDDisinformation	i:[, 1st, social]	disinformation:[, distrust, information, rejecting]	
#PfizerLeaks	leaks:[, information]	pfizer:[, authority, business, ref:pfizer, ref:pharma]	
#HealthCare	health:[, rights]	care:[, accepting]	
#DitchTheMask	ditch:[, rejecting]	mask:[, ref:mask, solution]	
#IStandWithBikies	i:[, 1st, social]	stand:[, accepting]	
#GetTheShot	get:[, accepting]	shot:[, ref:vaccine, solution]	
#LiveFeed	live:[, rights]	
#WakandaForever	wakanda:[, place, ref:africa]	forever:[, time]	
#AmericaCentral	america:[, place, ref:america]	
#ItalyUnderDidactorship	italy:[, place, ref:italy]	
#SackDanAndrews	dan:[, personal]	sack:[, rejecting]	andrews:[, personal]	
#EndMedicalTyranny	medical:[, authority, scientific]	tyranny:[, distrust, rejecting]	end:[, rejecting]	
#RememberPolio	remember:[, accepting]	polio:[, problem, ref:illness]	
#WhiteSupremacy	white:[, racial]	
#noApartheid	no:[, negation, rejecting]	apartheid:[, political, racial, rejecting]	
#NaziWorldOrder	nazi:[, distrust, ref:fascism, rejecting]	world:[, place]	
#GrowAPair	grow:[, accepting]	
#NoToCovidChil	no:[, negation, rejecting]	covid:[, problem, ref:covid]	
#MilanVerona	milan:[, place, ref:italy]	verona:[, personal, ref:italy]	
#ShameOnAussies	shame:[, rejecting]	aussies:[, place, ref:australia]	
#DoNoHarm	no:[, negation, rejecting]	harm:[, problem]	do:[, accepting]	
#ToryCriminals	tory:[, political, rightwing]	criminals:[, ref:crime, rejecting]	
#JudgementDay	day:[, time]	
#CourageIsContagious	contagious:[, problem, ref:illness]	is:[, opinionated]	courage:[, accepting]	
#YouGov	you:[, 2nd, social]	gov:[, authority, political]	
#AusOpen	open:[, accepting]	aus:[, place, ref:australia]	
#DesperateDan	dan:[, personal]	desperate:[, rejecting]	
#VaccinesWor	vaccines:[, ref:vaccine, solution]	
#VaccineSideE	vaccine:[, ref:vaccine, solution]	
#ItalianRes	italian:[, place, ref:italy]	
#ScotlandNeedsToStandUp	needs:[, rights]	stand:[, accepting]	scotland:[, place, ref:scotland]	
#DoNo	no:[, negation, rejecting]	do:[, accepting]	
#NoMandates	no:[, negation, rejecting]	mandates:[, responsibilities]	
#MetaStupid	stupid:[, rejecting]	
#StopAntivaxxers	stop:[, rejecting]	antivaxxers:[, ref:vaccine, rejecting, solution]	
#VaccineSideEffe	vaccine:[, ref:vaccine, solution]	
#IWillNOTComply	comply:[, accepting, responsibilities]	will:[, time]	i:[, 1st, social]	
#BloodClotting	clotting:[, problem, ref:illness]	
#JoeBidenDementia	biden:[, leftwing, personal, political, ref:biden, ref:democrats, social]	joe:[, leftwing, personal, political, ref:biden, ref:democrats]	dementia:[, problem, ref:illness]	
#aboriginalsRejectVAX	aboriginals:[, racial, ref:australia]	reject:[, rejecting]	
#ChildrenAreAGiftNotLabRats	gift:[, accepting]	not:[, negation, rejecting]	are:[, opinionated]	children:[, social]	rats:[, animal]	lab:[, leftwing, political]	
#NoMandatee	no:[, negation, rejecting]	mandatee:[, responsibilities]	
#FcukNaziUrsulaVonderLeyen	nazi:[, distrust, ref:fascism, rejecting]	ursula:[, personal]	fcuk:[, rejecting, vulgar]	
#NonAuP	au:[, place, ref:australia]	
#MoroccanProtests	protests:[, rejecting]	moroccan:[, place, ref:africa]	
#CovidLIARS	covid:[, problem, ref:covid]	i:[, 1st, social]	
#WeAreNotAlone	not:[, negation, rejecting]	are:[, opinionated]	we:[, 1st, social]	
#StopMaskingKids	masking:[, ref:mask, solution]	stop:[, rejecting]	kids:[, social]	
#FoxNews	news:[, information, ref:media]	fox:[, information, ref:fox_news, ref:media]	
#BestSummerEver	best:[, accepting]	summer:[, time]	
#DoNotComp	not:[, negation, rejecting]	do:[, accepting]	
#WakeUpAmerica	america:[, place, ref:america]	
#IStandWithFloyd	floyd:[, personal]	i:[, 1st, social]	stand:[, accepting]	
#OpenFora	open:[, accepting]	
#OurChildrenOurChoice	children:[, social]	choice:[, rights]	our:[, 1st, social]	
#GlobalRest	global:[, place]	
#FuckOffPlanB	fuck:[, rejecting, vulgar]	
#NoEuro	no:[, negation, rejecting]	euro:[, business, place, ref:eu, ref:europe]	
#SteveDeace	steve:[, personal]	
#ItIsOver	is:[, opinionated]	
#BorisMustGoNow	boris:[, personal, political, ref:boris_johnson, rightwing, social]	now:[, time]	go:[, accepting]	must:[, responsibilities]	
#StopTheCovidVaxPropaganda	covid:[, problem, ref:covid]	stop:[, rejecting]	propaganda:[, distrust, information, rejecting]	vax:[, ref:vaccine, solution]	
#ReinstateJoel	reinstate:[, accepting]	
#PharmaFascism	pharma:[, business, ref:pharma]	fascism:[, distrust, ref:fascism, rejecting]	
#FightforourFreedom	freedom:[, rights]	fightforour:[, 1st, rejecting]	
#ChooseLife	choose:[, accepting]	life:[, rights]	
#HoldTheLineAustria	austria:[, place, ref:austria]	
#AstroWorld	world:[, place]	astro:[, scientific]	
#SaturdayThoughts	saturday:[, time]	
#CancelDougF	cancel:[, rejecting]	doug:[, personal]	
#BioNTech	tech:[, solution]	bio:[, scientific]	
#CancelNickFerrari	nick:[, personal]	cancel:[, rejecting]	
#GreatReset	reset:[, rejecting]	great:[, accepting]	
#MelbourneProtestToday	today:[, time]	protest:[, rejecting]	melbourne:[, place, ref:australia]	
#JenPsaki	psaki:[, leftwing, personal]	
#NoVaxx	no:[, negation, rejecting]	vaxx:[, solution]	
#WeSeeYouBoris	boris:[, personal, political, ref:boris_johnson, rightwing, social]	you:[, 2nd, social]	we:[, 1st, social]	
#PandemicOfTheVaccina	pandemic:[, problem, ref:illness]	
#reinstateBernie	bernie:[, leftwing, personal, political, ref:bernie_sanders, ref:democrats]	reinstate:[, accepting]	
#OmicronIsAirborne	airborne:[, problem]	omicron:[, problem, ref:illness]	is:[, opinionated]	
#SaveNY	save:[, accepting]	
#NoVaccineNoPandemic	no:[, negation, rejecting]	vaccine:[, ref:vaccine, solution]	pandemic:[, problem, ref:illness]	
#FreedomRallyLondon	london:[, place, ref:uk]	freedom:[, rights]	rally:[, accepting]	
#CovidVacc	covid:[, problem, ref:covid]	vacc:[, ref:vaccine, solution]	
#CryptoGems	crypto:[, business]	
#UKNews	news:[, information, ref:media]	
#PlagueOClaus	plague:[, problem, ref:illness]	
#ThankYouDrFauci	thank:[, accepting]	fauci:[, authority, personal, ref:fauci]	dr:[, authority]	you:[, 2nd, social]	
#SeattleFirefighters	seattle:[, place, ref:america]	
#SuddenDeath	death:[, problem]	sudden:[, time]	
#TheVaccineIsMoreDeadlyThanTheVirus	deadly:[, problem]	vaccine:[, ref:vaccine, solution]	more:[, accepting]	is:[, opinionated]	virus:[, problem, ref:illness]	
#FinancialReset	financial:[, business]	reset:[, rejecting]	
#AShallNOTBeInfringed	be:[, accepting]	
#NoVaccineCoercion	no:[, negation, rejecting]	vaccine:[, ref:vaccine, solution]	coercion:[, rejecting]	
#LetsGoHochul	go:[, accepting]	lets:[, accepting]	
#NOGreenPass	green:[, ref:green, solution]	pass:[, ref:passport, responsibilities]	
#MayoClinic	mayo:[, place, ref:ireland]	clinic:[, solution]	
#NoMoreRestrictions	no:[, negation, rejecting]	more:[, accepting]	restrictions:[, responsibilities]	
#SayNoToTyranny	no:[, negation, rejecting]	tyranny:[, distrust, rejecting]	
#NoJusticeNoPeace	no:[, negation, rejecting]	peace:[, solution]	justice:[, rights]	
#DontDoIt	do:[, accepting]	dont:[, negation, rejecting]	
#IrishFreedomDay	freedom:[, rights]	irish:[, place, ref:ireland]	day:[, time]	
#CBSENews	news:[, information, ref:media]	
#RickNicholls	rick:[, personal]	
#RtePai	rte:[, information, ref:media]	
#VacunateYa	ya:[, social]	vacunate:[, ref:vaccine, solution]	
#NYCProtests	protests:[, rejecting]	
#PureEvil	evil:[, ref:crime, rejecting]	pure:[, accepting]	
#DunningKruger	dunning:[, personal]	
#MaskUp	mask:[, ref:mask, solution]	
#ScotlandIsNow	now:[, time]	is:[, opinionated]	scotland:[, place, ref:scotland]	
#FFauci	fauci:[, authority, personal, ref:fauci]	
#KidsFirst	kids:[, social]	
#HumanRight	right:[, accepting]	human:[, social]	
#NoVaccinePassportsAnywhere	no:[, negation, rejecting]	vaccine:[, ref:vaccine, solution]	passports:[, ref:passport, responsibilities]	
#EnglishNews	news:[, information, ref:media]	english:[, place, ref:uk]	
#FreedomFlu	freedom:[, rights]	flu:[, problem, ref:illness]	
#VaxScam	scam:[, distrust, rejecting]	vax:[, ref:vaccine, solution]	
#NoVaccinePassport	no:[, negation, rejecting]	vaccine:[, ref:vaccine, solution]	passport:[, ref:passport, responsibilities]	
#StrongerTogeth	stronger:[, accepting]	
#IChooseFreedom	freedom:[, rights]	i:[, 1st, social]	choose:[, accepting]	
#COVIDdenying	i:[, 1st, social]	
#UnitedWeRoar	united:[, accepting]	roar:[, rejecting]	we:[, 1st, social]	
#ioStoConStefanoPuzzer	con:[, distrust, rejecting]	stefano:[, personal]	
#VoteBlueNoMatterWho	no:[, negation, rejecting]	blue:[, leftwing, political]	vote:[, accepting]	
#PharmaffiaKilledDemocracy	pharmaffia:[, business, ref:pharma, rejecting]	killed:[, ref:crime, rejecting]	democracy:[, political, ref:democracy]	
#MyB	my:[, 1st, social]	
#DontCryPRGuy	cry:[, rejecting]	dont:[, negation, rejecting]	
#NoGreatReset	no:[, negation, rejecting]	reset:[, rejecting]	great:[, accepting]	
#TuesdayFeeling	tuesday:[, time]	
#CovidBooster	covid:[, problem, ref:covid]	booster:[, ref:vaccine, solution]	
#SackZahawi	sack:[, rejecting]	zahawi:[, personal]	
#NewWorldOrder	world:[, place]	
#VaxUp	vax:[, ref:vaccine, solution]	
#BigPhamaOwnsGov	phama:[, business]	gov:[, authority, political]	
#DontCryPR	cry:[, rejecting]	dont:[, negation, rejecting]	
#GetVaccinatedNow	now:[, time]	get:[, accepting]	vaccinated:[, ref:vaccine, solution]	
#NeverForget	never:[, negation, rejecting]	forget:[, rejecting]	
#BorisJohnsonOut	boris:[, personal, political, ref:boris_johnson, rightwing, social]	johnson:[, personal, political, ref:boris_johnson, rightwing, social]	
#EnoughI	i:[, 1st, social]	
#arrestBroula	arrest:[, rejecting]	
#NoCensorship	no:[, negation, rejecting]	censorship:[, distrust, rejecting, responsibilities]	
#NoVaccinePassportsAnywh	no:[, negation, rejecting]	vaccine:[, ref:vaccine, solution]	passports:[, ref:passport, responsibilities]	
#ChairmanDan	dan:[, personal]	chairman:[, authority]	
#MandatesAreNotLaws	not:[, negation, rejecting]	laws:[, responsibilities]	are:[, opinionated]	mandates:[, responsibilities]	
#TripleThreat	threat:[, problem]	
#ResistAllMandates	resist:[, rejecting]	mandates:[, responsibilities]	
#NoForcedvaccination	no:[, negation, rejecting]	
#LoveWins	wins:[, accepting]	love:[, accepting]	
#VaxMandate	mandate:[, responsibilities]	vax:[, ref:vaccine, solution]	
#StandWithChapmans	chapmans:[, personal]	stand:[, accepting]	
#NoGreenPassday	no:[, negation, rejecting]	green:[, ref:green, solution]	
#ClimateHOAX	climate:[, problem, ref:climate, ref:nature]	
#BerlinWall	berlin:[, place, ref:germany]	
#ThirdDoses	doses:[, solution]	
#PaperMasksDontWorkForViruses	viruses:[, problem, ref:illness]	work:[, responsibilities]	for:[, accepting]	masks:[, ref:mask, solution]	dont:[, negation, rejecting]	
#GenocideGames	genocide:[, ref:crime, rejecting]	
#COVIDireland	i:[, 1st, social]	
#AbortionRights	abortion:[, solution]	rights:[, rights]	
#NoVaccinePassportsAnywher	no:[, negation, rejecting]	vaccine:[, ref:vaccine, solution]	passports:[, ref:passport, responsibilities]	
#RightInOurFaces	right:[, accepting]	our:[, 1st, social]	
#CovidWarriors	covid:[, problem, ref:covid]	warriors:[, accepting]	
#JohnsonMustGo	go:[, accepting]	must:[, responsibilities]	johnson:[, personal, political, ref:boris_johnson, rightwing, social]	
#ReinstatedBernie	bernie:[, leftwing, personal, political, ref:bernie_sanders, ref:democrats]	
#FreedomOf	freedom:[, rights]	
#HelpUsHelpYou	help:[, accepting]	you:[, 2nd, social]	us:[, social]	
#notNormal	not:[, negation, rejecting]	
#ResistDefyDoNotComply	not:[, negation, rejecting]	comply:[, accepting, responsibilities]	resist:[, rejecting]	defy:[, rejecting]	do:[, accepting]	
#ClimateChangeHoax	change:[, rejecting]	climate:[, problem, ref:climate, ref:nature]	hoax:[, distrust, rejecting]	
#PoliceAccountability	police:[, authority]	accountability:[, responsibilities]	
#DenyServices	deny:[, rejecting]	
#WakeUpHumanity	humanity:[, social]	
#EndTyranny	tyranny:[, distrust, rejecting]	end:[, rejecting]	
#NotMyAustrali	not:[, negation, rejecting]	my:[, 1st, social]	
#IStandWithCinemaAndCo	i:[, 1st, social]	co:[, problem, ref:carbon, ref:nature]	stand:[, accepting]	
#UnlawfulManda	unlawful:[, rejecting]	
#RefuseToComply	comply:[, accepting, responsibilities]	refuse:[, rejecting]	
#FreeJulianAssange	assange:[, leftwing, personal, political, ref:julian_assange]	julian:[, personal]	free:[, rights]	
#LockdownsKill	lockdowns:[, responsibilities]	kill:[, problem, ref:crime, rejecting]	
#WorldPneumoniaDay	world:[, place]	pneumonia:[, problem, ref:illness]	day:[, time]	
#StandUpNowFreedom	freedom:[, rights]	now:[, time]	stand:[, accepting]	
#HappyThanksgiving	happy:[, accepting]	thanksgiving:[, time]	
#WeCanDoThis	do:[, accepting]	we:[, 1st, social]	
#AntiToryLiars	tory:[, political, rightwing]	liars:[, distrust, rejecting]	anti:[, rejecting]	
#CovidUpdates	covid:[, problem, ref:covid]	
#FauciDogTorturer	torturer:[, ref:crime, rejecting]	fauci:[, authority, personal, ref:fauci]	dog:[, animal]	
#KillerVAX	killer:[, ref:crime, rejecting]	
#BidensAm	am:[, opinionated]	bidens:[, leftwing, personal, political, ref:biden, ref:democrats, social]	
#TakeOffYourMasks	take:[, accepting]	masks:[, ref:mask, solution]	your:[, 2nd, social]	
#NoDigitalCurrency	digital:[, solution]	no:[, negation, rejecting]	currency:[, business]	
#AntiZionism	zionism:[, place, political, ref:israel]	anti:[, rejecting]	
#SnpCorruption	snp:[, political, ref:scotland]	corruption:[, distrust, rejecting]	
#RightToExpressDenied	right:[, accepting]	
#VoteACDP	vote:[, accepting]	
#TedCruz	cruz:[, personal, political, ref:republicans, ref:ted_cruz, ref:texas, rightwing]	
#GreatRes	great:[, accepting]	
#UnitedWeStand	united:[, accepting]	stand:[, accepting]	we:[, 1st, social]	
#OneOfTheMillion	million:[, numeric]	
#CostaRica	costa:[, place]	
#BetoForGovernor	beto:[, leftwing, personal, political, ref:america, ref:texas]	for:[, accepting]	governor:[, political]	
#ShameOnYouStephenDonnelly	shame:[, rejecting]	donnelly:[, personal]	stephen:[, personal]	you:[, 2nd, social]	
#StandWithFrance	france:[, place, ref:france]	stand:[, accepting]	
#ToryLies	tory:[, political, rightwing]	lies:[, distrust, information, rejecting]	
#QueenElizabeth	elizabeth:[, personal]	queen:[, authority]	
#HeyNext	next:[, time]	
#SolidarityFor	for:[, accepting]	solidarity:[, accepting]	
#TerryBradshaw	terry:[, personal]	
#UpholdRoeVWade	uphold:[, accepting]	
#ArrestSajidJavid	arrest:[, rejecting]	sajid:[, personal, political, rightwing]	javid:[, personal]	
#NotSafeOrEffective	effective:[, accepting]	not:[, negation, rejecting]	safe:[, rights]	
#NotMy	not:[, negation, rejecting]	my:[, 1st, social]	
#GiveNoQuarter	no:[, negation, rejecting]	give:[, accepting]	
#ndAmendment	amendment:[, authority]	
#NotReassuring	not:[, negation, rejecting]	
#ResistNFightBack	resist:[, rejecting]	fight:[, rejecting]	
#NoMan	no:[, negation, rejecting]	
#MandatoryVaccination	mandatory:[, responsibilities]	vaccination:[, ref:vaccine, solution]	
#NonALaVaccinationObligatoire	la:[, place]	obligatoire:[, responsibilities]	vaccination:[, ref:vaccine, solution]	
#FreedomNow	freedom:[, rights]	now:[, time]	
#CovidChargeCode	covid:[, problem, ref:covid]	charge:[, rejecting]	
#TestVaxxed	vaxxed:[, solution]	test:[, solution]	
#StopAttackingChildren	stop:[, rejecting]	children:[, social]	attacking:[, rejecting]	
#NoMaskMandate	no:[, negation, rejecting]	mandate:[, responsibilities]	mask:[, ref:mask, solution]	
#DrBridle	bridle:[, responsibilities]	dr:[, authority]	
#FauciLiedPeopleDied	died:[, problem]	fauci:[, authority, personal, ref:fauci]	people:[, social]	lied:[, distrust, rejecting]	
#WorldPolioDay	world:[, place]	day:[, time]	polio:[, problem, ref:illness]	
#AustriaHasF	austria:[, place, ref:austria]	
#GetTheVax	get:[, accepting]	vax:[, ref:vaccine, solution]	
#DEAliedMonkeysDied	monkeys:[, animal]	died:[, problem]	
#VaxXed	vax:[, ref:vaccine, solution]	
#RecallGavinNewsom	recall:[, rejecting]	gavin:[, leftwing, personal, political, ref:california, ref:democrats, ref:gavin_newsom]	newsom:[, leftwing, personal, political, ref:gavin_newsom]	
#RejectMandates	reject:[, rejecting]	mandates:[, responsibilities]	
#VaccinesSaveLives	lives:[, social]	vaccines:[, ref:vaccine, solution]	save:[, accepting]	
#TorySewag	tory:[, political, rightwing]	
#MyShot	my:[, 1st, social]	shot:[, ref:vaccine, solution]	
#covidScam	covid:[, problem, ref:covid]	scam:[, distrust, rejecting]	
#WhoIsDougBrodie	doug:[, personal]	is:[, opinionated]	
#WeWillAl	will:[, time]	we:[, 1st, social]	
#ProjectVeritas	veritas:[, religious]	
#OneLove	love:[, accepting]	
#NoVaxForKids	no:[, negation, rejecting]	for:[, accepting]	vax:[, ref:vaccine, solution]	kids:[, social]	
#NotAconspiracy	not:[, negation, rejecting]	aconspiracy:[, distrust, rejecting]	
#BioWeapon	weapon:[, problem, ref:crime]	bio:[, scientific]	
#FightForFreedom	freedom:[, rights]	for:[, accepting]	fight:[, rejecting]	
#VoluntaryConsentOnly	voluntary:[, accepting]	consent:[, rights]	
#TeamUSA	team:[, accepting]	
#WeAreNotLabRats	not:[, negation, rejecting]	are:[, opinionated]	rats:[, animal]	lab:[, leftwing, political]	we:[, 1st, social]	
#ToryCovidDisaster	covid:[, problem, ref:covid]	tory:[, political, rightwing]	disaster:[, problem, ref:nature]	
#BlackFriday	black:[, racial]	friday:[, time]	
#StopFiringPeople	stop:[, rejecting]	firing:[, rejecting]	people:[, social]	
#EndTheScamdemic	scamdemic:[, distrust, rejecting]	end:[, rejecting]	
#BidenHarris	biden:[, leftwing, personal, political, ref:biden, ref:democrats, social]	harris:[, leftwing, personal, political, ref:democrats, ref:kamala_harris]	
#WeWillA	will:[, time]	we:[, 1st, social]	
#DeathVaxx	death:[, problem]	vaxx:[, solution]	
#StopVaccinatingChildren	stop:[, rejecting]	children:[, social]	vaccinating:[, ref:vaccine, solution]	
#FreeAustralia	australia:[, place, ref:australia]	free:[, rights]	
#RealDeal	deal:[, business]	real:[, accepting]	
#VaxIllusion	vax:[, ref:vaccine, solution]	illusion:[, distrust, rejecting]	
#NoJabMe	no:[, negation, rejecting]	me:[, social]	jab:[, ref:vaccine, solution]	
#DepopulationPlan	depopulation:[, rejecting]	
#VoteFordOut	ford:[, business, personal]	vote:[, accepting]	
#DataScience	data:[, information, scientific]	science:[, authority, scientific]	
#IStandWithFreedomFighters	freedom:[, rights]	i:[, 1st, social]	stand:[, accepting]	fighters:[, accepting]	
#ThisIsO	is:[, opinionated]	
#TheirLaughingAtYou	their:[, 3rd]	you:[, 2nd, social]	laughing:[, rejecting]	
#StopTheCovidFearHoax	covid:[, problem, ref:covid]	stop:[, rejecting]	hoax:[, distrust, rejecting]	fear:[, rejecting]	
#EndSc	end:[, rejecting]	
#VaccineMessaging	vaccine:[, ref:vaccine, solution]	
#GlobalElite	elite:[, distrust, rejecting]	global:[, place]	
#CrimesAgai	crimes:[, problem, ref:crime, rejecting]	
#FreedomNotForce	not:[, negation, rejecting]	freedom:[, rights]	force:[, accepting]	
#CourageToAct	act:[, accepting]	courage:[, accepting]	
#DrLloydFisher	lloyd:[, personal]	dr:[, authority]	
#HateSpeech	hate:[, rejecting]	
#NoVaccineMan	no:[, negation, rejecting]	vaccine:[, ref:vaccine, solution]	
#KillShot	kill:[, problem, ref:crime, rejecting]	shot:[, ref:vaccine, solution]	
#MadeUpVariant	variant:[, problem, ref:illness]	
#VaccineSideEffectsThere	effects:[, problem]	vaccine:[, ref:vaccine, solution]	there:[, place]	
#VaccineApartheid	vaccine:[, ref:vaccine, solution]	apartheid:[, political, racial, rejecting]	
#StopTheMandates	stop:[, rejecting]	mandates:[, responsibilities]	
#FreedonOfChoice	freedon:[, rights]	choice:[, rights]	
#CountingOurDead	dead:[, problem]	our:[, 1st, social]	
#TheSkyIsFalling	sky:[, place, ref:nature]	is:[, opinionated]	
#NOTRosaParks	parks:[, place, ref:nature]	rosa:[, personal]	
#ArrestThemAllStartWithFauci	arrest:[, rejecting]	start:[, accepting]	them:[, 3rd, social]	fauci:[, authority, personal, ref:fauci]	
#TurdReich	turd:[, rejecting, vulgar]	reich:[, political, ref:fascism, rejecting]	
#LongCOVID	i:[, 1st, social]	
#CathayWagantall	cathay:[, business, ref:china]	
#BlackSwan	black:[, racial]	
#ProtectYourCommunity	your:[, 2nd, social]	protect:[, accepting]	community:[, social]	
#VoteScience	science:[, authority, scientific]	vote:[, accepting]	
#reutersUK	reuters:[, information, ref:media]	
#AlexJonesShow	alex:[, personal]	
#ProudBoys	proud:[, accepting]	boys:[, social]	
#BidenAdministrations	biden:[, leftwing, personal, political, ref:biden, ref:democrats, social]	
#TimeToTakeAStand	take:[, accepting]	time:[, time]	stand:[, accepting]	
#WorldAIDSDay	world:[, place]	i:[, 1st, social]	day:[, time]	
#GeneSimmons	simmons:[, personal]	gene:[, information, scientific]	
#VaccinationIsNotCompulsory	compulsory:[, responsibilities]	not:[, negation, rejecting]	is:[, opinionated]	vaccination:[, ref:vaccine, solution]	
#ScienceSaturday	saturday:[, time]	science:[, authority, scientific]	
#TogetherDeclaration	together:[, social]	
#freeAustralia	australia:[, place, ref:australia]	free:[, rights]	
#BillGatesKillerVax	gates:[, personal, ref:bill_gates]	bill:[, political]	killer:[, ref:crime, rejecting]	vax:[, ref:vaccine, solution]	
#NaziPass	nazi:[, distrust, ref:fascism, rejecting]	pass:[, ref:passport, responsibilities]	
#BadNurses	bad:[, rejecting]	nurses:[, solution]	
#BidenHarrisRegimeMustGo	biden:[, leftwing, personal, political, ref:biden, ref:democrats, social]	regime:[, political, rejecting]	harris:[, leftwing, personal, political, ref:democrats, ref:kamala_harris]	go:[, accepting]	must:[, responsibilities]	
#AxeTheVax	vax:[, ref:vaccine, solution]	axe:[, rejecting]	
#SupremeCourt	supreme:[, authority]	court:[, authority]	
#TheMaskofTheBeast	beast:[, animal, rejecting]	
#NoAlPaseSanitario	no:[, negation, rejecting]	
#NoMed	no:[, negation, rejecting]	
#VaccinatieSchade	vaccinatie:[, ref:vaccine, solution]	
#OVHealthcare	healthcare:[, solution]	
#NoToCoercion	no:[, negation, rejecting]	coercion:[, rejecting]	
#SajidJavid	sajid:[, personal, political, rightwing]	javid:[, personal]	
#COVIDVic	i:[, 1st, social]	
#NotoVaccineMandates	vaccine:[, ref:vaccine, solution]	mandates:[, responsibilities]	
#NaziAustralia	nazi:[, distrust, ref:fascism, rejecting]	australia:[, place, ref:australia]	
#BeLikeBernie	be:[, accepting]	bernie:[, leftwing, personal, political, ref:bernie_sanders, ref:democrats]	
#MarketingStrategy	marketing:[, business, ref:media]	strategy:[, accepting]	
#ConspiracyTheorists	conspiracy:[, distrust, rejecting]	
#LeaveUsAlone	leave:[, rejecting]	us:[, social]	
#VotingRightsAct	act:[, accepting]	rights:[, rights]	voting:[, political]	
#BetoORourke	beto:[, leftwing, personal, political, ref:america, ref:texas]	
#ClimateScam	scam:[, distrust, rejecting]	climate:[, problem, ref:climate, ref:nature]	
#VaccineNOTvaccine	vaccine:[, ref:vaccine, solution]	
#VaccineCentury	century:[, time]	vaccine:[, ref:vaccine, solution]	
#LockdownFuerUngeimpfte	lockdown:[, responsibilities]	
#EndThisNow	now:[, time]	end:[, rejecting]	
#ToryCriminalsUnfitToGovern	tory:[, political, rightwing]	govern:[, authority]	criminals:[, ref:crime, rejecting]	unfit:[, rejecting]	
#NoForcedVax	no:[, negation, rejecting]	forced:[, rejecting]	vax:[, ref:vaccine, solution]	
#CovidFearPorn	covid:[, problem, ref:covid]	porn:[, problem, ref:crime]	fear:[, rejecting]	
#noDiscrimination	no:[, negation, rejecting]	discrimination:[, racial]	
#SNPGreen	green:[, ref:green, solution]	
#TheGreatReset	reset:[, rejecting]	great:[, accepting]	
#MassProtests	protests:[, rejecting]	
#QRankzinnigheid	q:[, political, ref:q, rightwing]	
#RiseOurLives	lives:[, social]	rise:[, rejecting]	our:[, 1st, social]	
#HeilNWO	heil:[, political, ref:fascism, rejecting]	
#StudentsProtest	protest:[, rejecting]	
#DefundVaxMandates	defund:[, rejecting]	mandates:[, responsibilities]	vax:[, ref:vaccine, solution]	
#EQRCode	q:[, political, ref:q, rightwing]	
#CanYaSeeMeNow	now:[, time]	me:[, social]	ya:[, social]	
#TrudeauCorruption	trudeau:[, leftwing, personal, political, ref:trudeau, social]	corruption:[, distrust, rejecting]	
#CyberPolygon	cyber:[, scientific]	
#FailedGovernment	government:[, authority]	failed:[, rejecting]	
#HippocraticOath	oath:[, responsibilities]	hippocratic:[, scientific]	
#RomeProtests	rome:[, place, ref:italy]	protests:[, rejecting]	
#NeverGiveUp	give:[, accepting]	never:[, negation, rejecting]	
#NaziCovidVax	nazi:[, distrust, ref:fascism, rejecting]	covid:[, problem, ref:covid]	vax:[, ref:vaccine, solution]	
#GasChambers	gas:[, ref:fossil_fuel, ref:gas, solution]	
#SaveBulgaria	bulgaria:[, place, ref:europe]	save:[, accepting]	
#DoNorComply	comply:[, accepting, responsibilities]	do:[, accepting]	
#ReligiousExemption	religious:[, religious]	exemption:[, rights]	
#NoForcedVaccin	vaccin:[, ref:vaccine, solution]	no:[, negation, rejecting]	forced:[, rejecting]	
#mRNAVaccines	vaccines:[, ref:vaccine, solution]	
#LoveYourNeighbor	love:[, accepting]	your:[, 2nd, social]	neighbor:[, social]	
#TruthSeekers	truth:[, information, rights]	seekers:[, accepting]	
#OrganizedCr	organized:[, social]	
#CovidWasAnInsideJo	covid:[, problem, ref:covid]	inside:[, place]	
#SkyNews	news:[, information, ref:media]	sky:[, place, ref:nature]	
#NoToBoosters	no:[, negation, rejecting]	boosters:[, ref:vaccine, solution]	
#BillDeBlasio	de:[, personal]	blasio:[, leftwing, personal, political, ref:bill_deblasio, ref:democrats]	bill:[, political]	
#SleepyJoe	joe:[, leftwing, personal, political, ref:biden, ref:democrats]	
#PfizerLiedPeopleDied	pfizer:[, authority, business, ref:pfizer, ref:pharma]	died:[, problem]	people:[, social]	lied:[, distrust, rejecting]	
#CovidVaccineinj	covid:[, problem, ref:covid]	
#PopulationControl	control:[, responsibilities]	population:[, social]	
#ChapmansIceCream	chapmans:[, personal]	
#StopCoercion	stop:[, rejecting]	coercion:[, rejecting]	
#HoCoMD	co:[, problem, ref:carbon, ref:nature]	
#FauciLied	fauci:[, authority, personal, ref:fauci]	lied:[, distrust, rejecting]	
#NphetMustGo	nphet:[, authority]	go:[, accepting]	must:[, responsibilities]	
#TheKidsAreOk	are:[, opinionated]	ok:[, accepting]	kids:[, social]	
#IDoNotComply	not:[, negation, rejecting]	comply:[, accepting, responsibilities]	i:[, 1st, social]	do:[, accepting]	
#GoWOKEgetBROKE	go:[, accepting]	
#vaccineSide	vaccine:[, ref:vaccine, solution]	
#CovidVaxx	covid:[, problem, ref:covid]	vaxx:[, solution]	
#TruthAboutTembisa	truth:[, information, rights]	
#CovidLies	covid:[, problem, ref:covid]	lies:[, distrust, information, rejecting]	
#ResignBide	resign:[, rejecting]	
#BlackTwittermovement	black:[, racial]	
#NoVacvinePassportAnywhere	no:[, negation, rejecting]	passport:[, ref:passport, responsibilities]	vacvine:[, ref:vaccine, solution]	
#AntiVaxxers	vaxxers:[, accepting, ref:vaccine, solution]	anti:[, rejecting]	
#QRWeigeraar	q:[, political, ref:q, rightwing]	
#CrookedPolitician	politician:[, political]	crooked:[, distrust, ref:crime, rejecting]	
#LeaveThoseKidsAlone	leave:[, rejecting]	those:[, 3rd]	kids:[, social]	
#GovernmentTyranny	government:[, authority]	tyranny:[, distrust, rejecting]	
#SARSCoV	co:[, problem, ref:carbon, ref:nature]	
#StopTheTrialVaccinesNow	stop:[, rejecting]	vaccines:[, ref:vaccine, solution]	now:[, time]	trial:[, scientific, solution]	
#UbVaccinated	vaccinated:[, ref:vaccine, solution]	
#MSMLies	lies:[, distrust, information, rejecting]	
#CovidVax	covid:[, problem, ref:covid]	vax:[, ref:vaccine, solution]	
#ResistTyranny	tyranny:[, distrust, rejecting]	resist:[, rejecting]	
#GetVaxed	vaxed:[, ref:vaccine, solution]	get:[, accepting]	
#HouseOfCards	house:[, place]	
#IWillStandWithYou	will:[, time]	i:[, 1st, social]	stand:[, accepting]	you:[, 2nd, social]	
#SanFranciscos	san:[, place]	
#BidenAdministration	biden:[, leftwing, personal, political, ref:biden, ref:democrats, social]	administration:[, authority]	
#OperationLockstep	operation:[, business]	
#NoMoreLockdowns	lockdowns:[, responsibilities]	no:[, negation, rejecting]	more:[, accepting]	
#GreatResist	resist:[, rejecting]	great:[, accepting]	
#NoMadates	no:[, negation, rejecting]	madates:[, responsibilities]	
#FauciTheFraud	fraud:[, distrust, ref:crime, rejecting]	fauci:[, authority, personal, ref:fauci]	
#EricAdams	eric:[, personal]	
#StephenDonneLly	stephen:[, personal]	
#CultOfTheMisinformed	cult:[, distrust, rejecting]	misinformed:[, distrust, information, rejecting]	
#FolloForFolloBack	for:[, accepting]	
#CovidVic	covid:[, problem, ref:covid]	
#GetVaccinated#GetVac	get:[, accepting]	vaccinated:[, ref:vaccine, solution]	
#WatchDog	dog:[, animal]	
#ClimateHypocrite	climate:[, problem, ref:climate, ref:nature]	hypocrite:[, distrust, rejecting]	
#FreePress	free:[, rights]	
#GabrielPizza	gabriel:[, personal]	
#OmicronVirus	omicron:[, problem, ref:illness]	virus:[, problem, ref:illness]	
#FreeSpeech	free:[, rights]	
#VaccinePassport	vaccine:[, ref:vaccine, solution]	passport:[, ref:passport, responsibilities]	
#ListenToExperts	experts:[, authority]	listen:[, accepting]	
#VaxMandat	vax:[, ref:vaccine, solution]	
#ClimateHypocrisy	hypocrisy:[, distrust, rejecting]	climate:[, problem, ref:climate, ref:nature]	
#covidHoax	covid:[, problem, ref:covid]	hoax:[, distrust, rejecting]	
#BoycottCovidPassBars	covid:[, problem, ref:covid]	pass:[, ref:passport, responsibilities]	boycott:[, rejecting]	
#CovidIsReal	covid:[, problem, ref:covid]	is:[, opinionated]	real:[, accepting]	
#AustraliaHasNOTFallen	fallen:[, personal]	australia:[, place, ref:australia]	
#SaveChildren	children:[, social]	save:[, accepting]	
#JohnsonIsSp	is:[, opinionated]	johnson:[, personal, political, ref:boris_johnson, rightwing, social]	
#BOYCOTTChapmans	chapmans:[, personal]	
#VaccinesW	vaccines:[, ref:vaccine, solution]	
#IWill	will:[, time]	i:[, 1st, social]	
#EvilFDA	evil:[, ref:crime, rejecting]	
#NoVaccinePassportAnywher	no:[, negation, rejecting]	vaccine:[, ref:vaccine, solution]	passport:[, ref:passport, responsibilities]	
#FunVax	vax:[, ref:vaccine, solution]	
#WearADamnMask	damn:[, rejecting]	wear:[, accepting]	mask:[, ref:mask, solution]	
#ThisMorning	morning:[, time]	
#PandemicOfTheVaccinated	vaccinated:[, ref:vaccine, solution]	pandemic:[, problem, ref:illness]	
#WorldWideFreedomRall	world:[, place]	freedom:[, rights]	
#NoVaccineASU	no:[, negation, rejecting]	vaccine:[, ref:vaccine, solution]	
#PatientAdvocacy	advocacy:[, accepting]	
#PaidMedia	paid:[, business]	media:[, information, ref:media]	
#SpanishFlu	spanish:[, place, ref:spain]	flu:[, problem, ref:illness]	
#TheI	i:[, 1st, social]	
#EricClapton	clapton:[, personal]	eric:[, personal]	
#BidenDisaster	biden:[, leftwing, personal, political, ref:biden, ref:democrats, social]	disaster:[, problem, ref:nature]	
#DefundMedia	defund:[, rejecting]	media:[, information, ref:media]	
#CannabisCommunity	community:[, social]	
#SatanIsShowing	satan:[, rejecting, religious]	is:[, opinionated]	
#ElectionBreaking	election:[, political]	breaking:[, rejecting]	
#VaccineSideEff	vaccine:[, ref:vaccine, solution]	eff:[, rejecting, vulgar]	
#NoJabForMe	no:[, negation, rejecting]	me:[, social]	for:[, accepting]	jab:[, ref:vaccine, solution]	
#ProCho	cho:[, personal]	pro:[, accepting]	
#TakeOffYourMask	take:[, accepting]	your:[, 2nd, social]	mask:[, ref:mask, solution]	
#VaxLiars	liars:[, distrust, rejecting]	vax:[, ref:vaccine, solution]	
#FkTonyFauci	tony:[, personal]	fauci:[, authority, personal, ref:fauci]	
#NoVaxPassports	no:[, negation, rejecting]	passports:[, ref:passport, responsibilities]	vax:[, ref:vaccine, solution]	
#NoCovidPass	no:[, negation, rejecting]	covid:[, problem, ref:covid]	pass:[, ref:passport, responsibilities]	
#ElectionsResult	elections:[, political]	
#StopObeying	stop:[, rejecting]	
#HandsOffOurChildre	our:[, 1st, social]	
#BeatChina	china:[, place, ref:china]	beat:[, rejecting]	
#WeWillAllBeThere	be:[, accepting]	will:[, time]	there:[, place]	we:[, 1st, social]	
#GetYourBoosterShot	get:[, accepting]	your:[, 2nd, social]	booster:[, ref:vaccine, solution]	shot:[, ref:vaccine, solution]	
#BigPharmaGreed	greed:[, rejecting]	pharma:[, business, ref:pharma]	
#TrickOrTreat	treat:[, solution]	trick:[, distrust, rejecting]	
#JacindaOut	jacinda:[, personal, ref:jacinda_ardern]	
#TheDrugsDontWork	drugs:[, ref:drugs, solution]	work:[, responsibilities]	dont:[, negation, rejecting]	
#PCRTest	test:[, solution]	
#GetVaccinated	get:[, accepting]	vaccinated:[, ref:vaccine, solution]	
#JacindaArdern	jacinda:[, personal, ref:jacinda_ardern]	ardern:[, personal, ref:jacinda_ardern]	
#FreeHumanity	free:[, rights]	humanity:[, social]	
#GetArmed	get:[, accepting]	
#VaccineIsPoison	vaccine:[, ref:vaccine, solution]	poison:[, problem, ref:crime, ref:nature]	is:[, opinionated]	
#NoMandat	no:[, negation, rejecting]	
#NoVaccinePasspo	no:[, negation, rejecting]	vaccine:[, ref:vaccine, solution]	
#NicholasSeppy	nicholas:[, personal]	
#SomyurekTheBill	bill:[, political]	
#WednesdayMotivation	motivation:[, accepting]	wednesday:[, time]	
#BonnieHenry	henry:[, personal]	bonnie:[, personal]	
#ConservativeBigBlueTent	conservative:[, political, rightwing]	blue:[, leftwing, political]	
#GOPDeathCult	cult:[, distrust, rejecting]	death:[, problem]	
#PodcastBanter	podcast:[, information, ref:media]	
#MedicalApartide	medical:[, authority, scientific]	
#TheirABC	their:[, 3rd]	
#CrimeMinister	minister:[, political]	crime:[, ref:crime, rejecting]	
#ClimateChangeDeniers	change:[, rejecting]	climate:[, problem, ref:climate, ref:nature]	deniers:[, distrust, rejecting]	
#DigitalTransformation	digital:[, solution]	transformation:[, solution]	
#RadioGenova	radio:[, information, ref:media]	
#ImWithBigBird	im:[, 1st, social]	bird:[, animal]	
#CubaLibre	cuba:[, place, ref:cuba]	
#BoycottSesa	boycott:[, rejecting]	
#NoMoreLockdo	no:[, negation, rejecting]	more:[, accepting]	
#BigBrotherJohnson	johnson:[, personal, political, ref:boris_johnson, rightwing, social]	
#BlackTwitter	twitter:[, information, ref:media]	black:[, racial]	
#VaccineClinic	vaccine:[, ref:vaccine, solution]	clinic:[, solution]	
#VaccineNOT	vaccine:[, ref:vaccine, solution]	
#CdnPoli	poli:[, political]	cdn:[, place, political]	
#TennesseeCOVID	i:[, 1st, social]	
#NoClimateEmergency	no:[, negation, rejecting]	emergency:[, problem]	climate:[, problem, ref:climate, ref:nature]	
#NoVac	no:[, negation, rejecting]	
#PoliceState	police:[, authority]	state:[, place]	
#IdoNOTconsent	ido:[, 1st]	
#PandemicInTheRearViewMirror	pandemic:[, problem, ref:illness]	
#GoVaxx	go:[, accepting]	vaxx:[, solution]	
#CovidMURDERERS	covid:[, problem, ref:covid]	
#LiveFree	free:[, rights]	live:[, rights]	
#NoMor	no:[, negation, rejecting]	
#disbandNPHET	disband:[, rejecting]	
#WeWi	we:[, 1st, social]	
#NoMedicalApart	no:[, negation, rejecting]	medical:[, authority, scientific]	
#FauciLeaks	leaks:[, information]	fauci:[, authority, personal, ref:fauci]	
#HumanRightsViolations	violations:[, ref:crime, rejecting]	rights:[, rights]	human:[, social]	
#NeverV	never:[, negation, rejecting]	
#GlobalNazis	global:[, place]	nazis:[, distrust, political, ref:fascism, rejecting]	
#DemandEvidence	evidence:[, information]	demand:[, responsibilities]	
#NotMyAustralia	not:[, negation, rejecting]	australia:[, place, ref:australia]	my:[, 1st, social]	
#VaccineCoverups	vaccine:[, ref:vaccine, solution]	coverups:[, distrust, ref:crime, rejecting]	
#GRomeSummit	rome:[, place, ref:italy]	summit:[, political]	
#JoeBidensAmerica	joe:[, leftwing, personal, political, ref:biden, ref:democrats]	bidens:[, leftwing, personal, political, ref:biden, ref:democrats, social]	america:[, place, ref:america]	
#MakeOrwellFictionAgain	fiction:[, distrust, rejecting]	make:[, accepting]	
#SaveTheChildrenPlease	children:[, social]	save:[, accepting]	please:[, accepting]	
#StopVaxingKids	stop:[, rejecting]	kids:[, social]	vaxing:[, ref:vaccine, solution]	
#ChuckTodd	chuck:[, personal]	
#LambdaVariant	variant:[, problem, ref:illness]	
#CovidCrimesAgainstHumanity	covid:[, problem, ref:covid]	against:[, rejecting]	crimes:[, problem, ref:crime, rejecting]	humanity:[, social]	
#NoVaccinePassportsANYWHERE	no:[, negation, rejecting]	vaccine:[, ref:vaccine, solution]	passports:[, ref:passport, responsibilities]	
#VirusScam	scam:[, distrust, rejecting]	virus:[, problem, ref:illness]	
#LockHimUp	him:[, 3rd, social]	
#MSMLiars	liars:[, distrust, rejecting]	
#SaveTheKids	save:[, accepting]	kids:[, social]	
#UrsulaVonDerLeyen	ursula:[, personal]	
#CoronaVirusCanada	canada:[, place, ref:canada]	virus:[, problem, ref:illness]	corona:[, problem, ref:corona, ref:illness]	
#DoYouSeeItYet	do:[, accepting]	you:[, 2nd, social]	
#YoNoMeVacuno	no:[, negation, rejecting]	me:[, social]	
#ClimateScience	science:[, authority, scientific]	climate:[, problem, ref:climate, ref:nature]	
#IUtah	utah:[, place, ref:america]	i:[, 1st, social]	
#JeremyVine	jeremy:[, personal]	
#LeaveOu	leave:[, rejecting]	
#WillNotComplyEVER	not:[, negation, rejecting]	comply:[, accepting, responsibilities]	will:[, time]	
#SpyGate	gate:[, distrust, political, rejecting]	spy:[, rejecting]	
#EqualTesting	testing:[, solution]	
#NonAuPasse	au:[, place, ref:australia]	passe:[, ref:passport, responsibilities]	
#NoVaccinePassort	no:[, negation, rejecting]	vaccine:[, ref:vaccine, solution]	
#BuildBackBetter	better:[, accepting]	
#GetVaccinated#FullyVaccinated#COVIDIOTS	get:[, accepting]	i:[, 1st, social]	vaccinated:[, ref:vaccine, solution]	
#PlagueSpreadersCaucus	spreaders:[, problem, ref:illness]	caucus:[, political]	plague:[, problem, ref:illness]	
#SackPatKenny	sack:[, rejecting]	kenny:[, personal]	
#ClapForTheNHS	clap:[, accepting]	for:[, accepting]	
#COVIDScam	scam:[, distrust, rejecting]	i:[, 1st, social]	
#EUNazis	nazis:[, distrust, political, ref:fascism, rejecting]	
#BanCovidVaxNow	covid:[, problem, ref:covid]	now:[, time]	vax:[, ref:vaccine, solution]	ban:[, rejecting]	
#NoVaccineSanctions	no:[, negation, rejecting]	vaccine:[, ref:vaccine, solution]	sanctions:[, responsibilities]	
#FauciHumanExperimentation	experimentation:[, scientific, solution]	fauci:[, authority, personal, ref:fauci]	human:[, social]	
#TheMediaIsTheVirus	is:[, opinionated]	media:[, information, ref:media]	virus:[, problem, ref:illness]	
#LosAngeles	los:[, place]	
#NoGreenPassObligatorio	no:[, negation, rejecting]	green:[, ref:green, solution]	pass:[, ref:passport, responsibilities]	obligatorio:[, responsibilities]	
#StandInThePark	stand:[, accepting]	park:[, place]	
#JailPfizer	pfizer:[, authority, business, ref:pfizer, ref:pharma]	jail:[, ref:crime, rejecting]	
#CovidAppBoycott	covid:[, problem, ref:covid]	boycott:[, rejecting]	
#ScottishIndependence	scottish:[, place, ref:scotland]	
#NoVax	no:[, negation, rejecting]	vax:[, ref:vaccine, solution]	
#RidiculousBehaviour	ridiculous:[, rejecting]	
#UrsulavonderLeyens	ursulavonder:[, personal, political, ref:eu, ref:europe]	
#BuenosAires	buenos:[, place, ref:argentina]	
#GetVacci	vacci:[, ref:vaccine, solution]	get:[, accepting]	
#DoNotComply	not:[, negation, rejecting]	comply:[, accepting, responsibilities]	do:[, accepting]	
#NoTwoTierSociety	no:[, negation, rejecting]	society:[, social]	
#DoFo	do:[, accepting]	
#SundayThoughts	sunday:[, time]	
#NoMoreSnakeOil	no:[, negation, rejecting]	oil:[, problem, ref:fossil_fuel, ref:nature, ref:oil]	more:[, accepting]	snake:[, rejecting]	
#EnoughIsE	is:[, opinionated]	
#PublicTransport	public:[, social]	transport:[, business]	
#LeaveNoDoubt	no:[, negation, rejecting]	leave:[, rejecting]	
#ResignYousaf	yousaf:[, personal]	resign:[, rejecting]	
#TrudeauM	trudeau:[, leftwing, personal, political, ref:trudeau, social]	
#ShameOnYou	shame:[, rejecting]	you:[, 2nd, social]	
#RomeGSummit	rome:[, place, ref:italy]	summit:[, political]	
#BlackTwitterMovement	twitter:[, information, ref:media]	black:[, racial]	movement:[, political]	
#FreeSpeechMatters	free:[, rights]	
#NoV	no:[, negation, rejecting]	
#FlatEarth	earth:[, place]	
#NationalClottery	national:[, place]	clottery:[, problem, ref:illness, rejecting]	
#FreshV	fresh:[, accepting]	
#ToryCovidCatastrophe	covid:[, problem, ref:covid]	tory:[, political, rightwing]	catastrophe:[, problem, ref:nature]	
#CrimesAgainsHumanity	crimes:[, problem, ref:crime, rejecting]	agains:[, rejecting]	humanity:[, social]	
#GlobalElites	global:[, place]	elites:[, authority, distrust, rejecting]	
#MommaBear	bear:[, animal]	momma:[, social]	
#OpDomesticTerr	domestic:[, place]	
#FraudVaccine	vaccine:[, ref:vaccine, solution]	fraud:[, distrust, ref:crime, rejecting]	
#SuddenCollap	sudden:[, time]	
#NoG	no:[, negation, rejecting]	
#EndTyrannyNOW	tyranny:[, distrust, rejecting]	end:[, rejecting]	
#FreeThemAll	them:[, 3rd, social]	free:[, rights]	
#NoM	no:[, negation, rejecting]	
#TerribleTuesday	tuesday:[, time]	terrible:[, rejecting]	
#RiseMebourne	rise:[, rejecting]	
#ProsecuteJacinda	jacinda:[, personal, ref:jacinda_ardern]	prosecute:[, rejecting]	
#MaskMandate	mandate:[, responsibilities]	mask:[, ref:mask, solution]	
#GlobalistSlave	slave:[, racial, rejecting]	globalist:[, rejecting]	
#DidYouGetYourBooster	get:[, accepting]	your:[, 2nd, social]	booster:[, ref:vaccine, solution]	you:[, 2nd, social]	
#SatanicCult	cult:[, distrust, rejecting]	satanic:[, rejecting, religious]	
#HealthcareHeroes	heroes:[, accepting]	healthcare:[, solution]	
#NaziMasks	nazi:[, distrust, ref:fascism, rejecting]	masks:[, ref:mask, solution]	
#GlobalProtest	global:[, place]	protest:[, rejecting]	
#StandWithNurseKat	nurse:[, solution]	stand:[, accepting]	
#RiseUpAustralia	australia:[, place, ref:australia]	rise:[, rejecting]	
#IStandWithCareWorkers	i:[, 1st, social]	stand:[, accepting]	workers:[, business]	care:[, accepting]	
#NoForcedInjections	injections:[, solution]	no:[, negation, rejecting]	forced:[, rejecting]	
#GoBrandon	brandon:[, personal, political, rightwing]	go:[, accepting]	
#ThisIsNotANegotiation	not:[, negation, rejecting]	negotiation:[, accepting]	is:[, opinionated]	
#MakeCatNapTimeMandatory	cat:[, animal]	time:[, time]	mandatory:[, responsibilities]	make:[, accepting]	
#TrustGod	trust:[, accepting]	god:[, religious]	
#LungClots	clots:[, problem, ref:illness]	lung:[, problem, ref:illness]	
#FreshVoicesRise	voices:[, information]	rise:[, rejecting]	fresh:[, accepting]	
#COVIDVa	i:[, 1st, social]	
#PassDeL	de:[, personal]	pass:[, ref:passport, responsibilities]	
#DoNotObey	not:[, negation, rejecting]	obey:[, accepting]	do:[, accepting]	
#MillionsMarch	millions:[, numeric]	
#WorldLeadersSilent	silent:[, accepting]	world:[, place]	leaders:[, authority]	
#BuildBackBroke	broke:[, rejecting]	
#BidenIsAFailure	biden:[, leftwing, personal, political, ref:biden, ref:democrats, social]	failure:[, rejecting]	is:[, opinionated]	
#ImmuneSystem	immune:[, solution]	
#GetYourCovidBooster	covid:[, problem, ref:covid]	get:[, accepting]	your:[, 2nd, social]	booster:[, ref:vaccine, solution]	
#GetFullyVaxxed	vaxxed:[, solution]	get:[, accepting]	
#VaincreLeCovi	covi:[, problem, ref:covid, ref:illness]	
#VaccineTaboo	vaccine:[, ref:vaccine, solution]	taboo:[, rejecting]	
#PublicHealthEngland	england:[, place, ref:uk]	public:[, social]	health:[, rights]	
#CapitalismKills	kills:[, ref:crime, rejecting]	capitalism:[, business]	
#MelbourneProtests	protests:[, rejecting]	melbourne:[, place, ref:australia]	
#ConspiracyTheory	conspiracy:[, distrust, rejecting]	theory:[, information, scientific]	
#StayInformed	informed:[, information]	stay:[, accepting]	
#NoGreenPa	no:[, negation, rejecting]	green:[, ref:green, solution]	
#NoNWO	no:[, negation, rejecting]	
#novaccinePassports	passports:[, ref:passport, responsibilities]	
#MakeHealthPrimary	health:[, rights]	make:[, accepting]	primary:[, political]	
#WearAMa	ma:[, social]	wear:[, accepting]	
#BoostersAreFree	are:[, opinionated]	boosters:[, ref:vaccine, solution]	free:[, rights]	
#WokeFascism	woke:[, leftwing, political]	fascism:[, distrust, ref:fascism, rejecting]	
#TellTheTruth	truth:[, information, rights]	
#TruthWins	wins:[, accepting]	truth:[, information, rights]	
#WuhanFl	wuhan:[, place, ref:china]	
#NoNaziPass	nazi:[, distrust, ref:fascism, rejecting]	no:[, negation, rejecting]	pass:[, ref:passport, responsibilities]	
#DataAnalytics	analytics:[, scientific]	data:[, information, scientific]	
#NeverGiveUP	give:[, accepting]	never:[, negation, rejecting]	
#OncTwitter	twitter:[, information, ref:media]	
#CovidVaccineRace	vaccine:[, ref:vaccine, solution]	covid:[, problem, ref:covid]	race:[, racial]	
#HumanMorbidityFatility	morbidity:[, problem, ref:illness]	human:[, social]	
#SaveTheBabyHumans	baby:[, social]	save:[, accepting]	humans:[, social]	
#FuckOffBoris	boris:[, personal, political, ref:boris_johnson, rightwing, social]	fuck:[, rejecting, vulgar]	
#BenGarrison	ben:[, personal]	
#NoLockdowns	lockdowns:[, responsibilities]	no:[, negation, rejecting]	
#FuckJoeBiden	biden:[, leftwing, personal, political, ref:biden, ref:democrats, social]	joe:[, leftwing, personal, political, ref:biden, ref:democrats]	fuck:[, rejecting, vulgar]	
#FirstDoNoHarm	no:[, negation, rejecting]	harm:[, problem]	do:[, accepting]	
#NoMoreApologies	no:[, negation, rejecting]	more:[, accepting]	apologies:[, accepting]	
#WearAMaskSaveALife	save:[, accepting]	wear:[, accepting]	life:[, rights]	mask:[, ref:mask, solution]	
#FordFailedThePeople	failed:[, rejecting]	ford:[, business, personal]	people:[, social]	
#GetRidOfBoris	boris:[, personal, political, ref:boris_johnson, rightwing, social]	get:[, accepting]	rid:[, rejecting]	
#CentralCoast	coast:[, place]	
#ToryCorruption	tory:[, political, rightwing]	corruption:[, distrust, rejecting]	
#TrueBlood	true:[, accepting]	
#WeThePeople	people:[, social]	we:[, 1st, social]	
#SerbianRevolution	revolution:[, rejecting]	serbian:[, place, ref:europe]	
#ThinkForYourself	for:[, accepting]	yourself:[, 2nd, social]	
#CovidCon	covid:[, problem, ref:covid]	con:[, distrust, rejecting]	
#EpsteinIsland	epstein:[, personal]	island:[, place]	
#FraudAlert	alert:[, rejecting]	fraud:[, distrust, ref:crime, rejecting]	
#NonAuPassSani	au:[, place, ref:australia]	pass:[, ref:passport, responsibilities]	
#CapeTown	town:[, place]	cape:[, place]	
#resignKieranMoore	kieran:[, personal]	resign:[, rejecting]	
#noGREENpass	no:[, negation, rejecting]	
#SackAdrianCummins	sack:[, rejecting]	adrian:[, personal]	
#GetVaccinat	get:[, accepting]	
#ServeAndProtect	protect:[, accepting]	serve:[, accepting]	
#EUCovidCertificate	covid:[, problem, ref:covid]	certificate:[, responsibilities, solution]	
#wakeupScotland	wakeup:[, rejecting]	scotland:[, place, ref:scotland]	
#OpenForSummer	for:[, accepting]	summer:[, time]	open:[, accepting]	
#crimesAgainstHumanity	against:[, rejecting]	crimes:[, problem, ref:crime, rejecting]	humanity:[, social]	
#AmericasFrontlineDoctors	frontline:[, solution]	doctors:[, authority]	americas:[, place, ref:america]	
#HumanRightsViolated	violated:[, rejecting]	rights:[, rights]	human:[, social]	
#MoronicVariant	moronic:[, rejecting]	variant:[, problem, ref:illness]	
#FreshAir	fresh:[, accepting]	
#PublicHealthScotland	public:[, social]	health:[, rights]	scotland:[, place, ref:scotland]	
#WeR	we:[, 1st, social]	
#MediaIsTheVirus	is:[, opinionated]	media:[, information, ref:media]	virus:[, problem, ref:illness]	
#WeW	we:[, 1st, social]	
#CivilLiberties	civil:[, social]	
#DougFords	doug:[, personal]	
#StayAwayFromMyChildren	away:[, rejecting]	children:[, social]	my:[, 1st, social]	stay:[, accepting]	
#JustSayNoToBigBird	no:[, negation, rejecting]	bird:[, animal]	
#SayNoToMandate	no:[, negation, rejecting]	mandate:[, responsibilities]	
#TheNationals	nationals:[, place]	
#WearAM	wear:[, accepting]	
#letsgoBrandon	letsgo:[, accepting]	brandon:[, personal, political, rightwing]	
#CovidToe	covid:[, problem, ref:covid]	
#DenverPD	denver:[, place, ref:america]	
#ShakespeareSunday	sunday:[, time]	
#NoTotal	no:[, negation, rejecting]	
#PersonalResponsibility	responsibility:[, responsibilities]	personal:[, personal]	
#DoNot	not:[, negation, rejecting]	do:[, accepting]	
#ClimateEmerge	climate:[, problem, ref:climate, ref:nature]	
#VFMario	mario:[, personal]	
#AustriaHasFallen	fallen:[, personal]	austria:[, place, ref:austria]	
#ObamaSoFine	fine:[, rejecting]	obama:[, leftwing, personal, political, ref:barack_obama, ref:democrats]	
#ToryDictators	tory:[, political, rightwing]	dictators:[, distrust, political, rejecting]	
#WeStandWithIsrael	israel:[, place, ref:israel]	stand:[, accepting]	we:[, 1st, social]	
#VaccineDodger	vaccine:[, ref:vaccine, solution]	
#VoteForLiberty	liberty:[, rights]	for:[, accepting]	vote:[, accepting]	
#SackedCarers	sacked:[, rejecting]	
#VaccineMandates	vaccine:[, ref:vaccine, solution]	mandates:[, responsibilities]	
#FakeSocialist	socialist:[, leftwing, political]	fake:[, distrust, rejecting]	
#TogetherDec	together:[, social]	
#LetDoctorsBeDoctors	be:[, accepting]	doctors:[, authority]	let:[, accepting]	
#WorldwideFreedomRally	freedom:[, rights]	rally:[, accepting]	
#VaccinateOurKids	vaccinate:[, ref:vaccine, solution]	our:[, 1st, social]	kids:[, social]	
#FollowSafetyProtocols	safety:[, solution]	protocols:[, responsibilities]	follow:[, accepting]	
#SciComm	sci:[, scientific]	
#EndTheStateOfEmergency	emergency:[, problem]	end:[, rejecting]	state:[, place]	
#AussieRevolution	aussie:[, place, ref:australia]	revolution:[, rejecting]	
#AntiMandate	mandate:[, responsibilities]	anti:[, rejecting]	
#BBCNews	news:[, information, ref:media]	
#FreedomOfChoice	freedom:[, rights]	choice:[, rights]	
#NoMore	no:[, negation, rejecting]	more:[, accepting]	
#IHaveAVoice	voice:[, information]	i:[, 1st, social]	
#TheGreatResignation	resignation:[, rejecting]	great:[, accepting]	
#RefuseTheGre	refuse:[, rejecting]	
#BigPharmaCa	pharma:[, business, ref:pharma]	ca:[, place, ref:canada]	
#DontComply	comply:[, accepting, responsibilities]	dont:[, negation, rejecting]	
#NorthCarolina	north:[, place]	
#NaziGermany	nazi:[, distrust, ref:fascism, rejecting]	germany:[, place, ref:germany]	
#GreenPass	green:[, ref:green, solution]	pass:[, ref:passport, responsibilities]	
#BillGatesBioTerrorist	gates:[, personal, ref:bill_gates]	bio:[, scientific]	bill:[, political]	terrorist:[, ref:crime, rejecting]	
#ArrestWhitty	arrest:[, rejecting]	whitty:[, authority, personal]	
#InformedConsent	informed:[, information]	consent:[, rights]	
#PatriotsUnite	unite:[, social]	patriots:[, accepting]	
#TheyWalkAmongUs	us:[, social]	they:[, 3rd, social]	
#NoVaxMandates	no:[, negation, rejecting]	mandates:[, responsibilities]	vax:[, ref:vaccine, solution]	
#MandateThis	mandate:[, responsibilities]	
#FightBack	fight:[, rejecting]	
#MyBodyMyChoice	choice:[, rights]	body:[, social]	my:[, 1st, social]	
#COVIDa	i:[, 1st, social]	
#UKGovernment	government:[, authority]	
#HealthAndCareBill	bill:[, political]	health:[, rights]	care:[, accepting]	
#NoVme	no:[, negation, rejecting]	
#WhiteJesusCult	jesus:[, religious]	cult:[, distrust, rejecting]	white:[, racial]	
#NoMasksAnywhere	no:[, negation, rejecting]	masks:[, ref:mask, solution]	
#VaccineHesitants	hesitants:[, rejecting]	vaccine:[, ref:vaccine, solution]	
#CivilDisobedienceNow	disobedience:[, rejecting]	now:[, time]	civil:[, social]	
#TruthShallPrevail	truth:[, information, rights]	
#SanDiego	san:[, place]	diego:[, personal]	
#WeAreMany	are:[, opinionated]	we:[, 1st, social]	
#UnitedweStand	stand:[, accepting]	
#NorthKorea	korea:[, place, ref:asia, ref:korea]	north:[, place]	
#RapistsRepent	repent:[, religious]	rapists:[, rejecting]	
#NoMandatoryJabs	no:[, negation, rejecting]	jabs:[, ref:vaccine, solution]	mandatory:[, responsibilities]	
#NationalShutdown	national:[, place]	shutdown:[, rejecting]	
#CreatedEmergencies	emergencies:[, problem]	
#BoycottAustralianOpen	australian:[, place, ref:australia]	boycott:[, rejecting]	open:[, accepting]	
#FuckJoeandtheKamelToeHo	fuck:[, rejecting, vulgar]	joeandthe:[, leftwing, personal, political, ref:biden, ref:democrats]	
#NoMandato	no:[, negation, rejecting]	
#StandFree	free:[, rights]	stand:[, accepting]	
#FreedomFighters	freedom:[, rights]	fighters:[, accepting]	
#FuckBlockchain	fuck:[, rejecting, vulgar]	
#TheMillion	million:[, numeric]	
#MedicalFreedom	medical:[, authority, scientific]	freedom:[, rights]	
#meinFauci	fauci:[, authority, personal, ref:fauci]	mein:[, political, ref:fascism, rejecting]	
#VaccineBreakthrough	vaccine:[, ref:vaccine, solution]	breakthrough:[, accepting]	
#WindsorPark	windsor:[, place, ref:uk]	park:[, place]	
#SayNoToJab	no:[, negation, rejecting]	jab:[, ref:vaccine, solution]	
#FcukOffCoveney	fcuk:[, rejecting, vulgar]	
#VaxxItOrCasket	casket:[, problem]	vaxx:[, solution]	
#UnmaskOurChildren	children:[, social]	our:[, 1st, social]	unmask:[, ref:mask, rejecting]	
#TogetherDeclar	together:[, social]	
#SaveOurKids	save:[, accepting]	our:[, 1st, social]	kids:[, social]	
#FearPorn	porn:[, problem, ref:crime]	fear:[, rejecting]	
#WeSeeTheirPlan	their:[, 3rd]	we:[, 1st, social]	
#TheGreatGlo	great:[, accepting]	
#LockdownLockout	lockdown:[, responsibilities]	
#NoCertificado	no:[, negation, rejecting]	certificado:[, responsibilities]	
#VivaItalia	italia:[, place, ref:italy]	viva:[, accepting]	
#NoApartheid	no:[, negation, rejecting]	apartheid:[, political, racial, rejecting]	
#WorldWide	world:[, place]	
#ReclaimThe	reclaim:[, accepting]	
#CancelTheLockdown	cancel:[, rejecting]	lockdown:[, responsibilities]	
#AbortionBan	abortion:[, solution]	ban:[, rejecting]	
#DemocratsAreFascists	fascists:[, distrust, political, ref:fascism, rejecting, rightwing]	are:[, opinionated]	democrats:[, leftwing, political, ref:democrats]	
#ForcedVaccination	forced:[, rejecting]	vaccination:[, ref:vaccine, solution]	
#ClimateHoax	climate:[, problem, ref:climate, ref:nature]	hoax:[, distrust, rejecting]	
#QueenJames	queen:[, authority]	james:[, personal]	
#ClimateTAXES	climate:[, problem, ref:climate, ref:nature]	
#ResistCovid	covid:[, problem, ref:covid]	resist:[, rejecting]	
#AvGeek	geek:[, rejecting]	
#IStandWithItaly	i:[, 1st, social]	stand:[, accepting]	italy:[, place, ref:italy]	
#NoGreenPassObbligatorio	no:[, negation, rejecting]	green:[, ref:green, solution]	pass:[, ref:passport, responsibilities]	obbligatorio:[, responsibilities]	
#NewsBreak	news:[, information, ref:media]	break:[, rejecting]	
#BloodClots	clots:[, problem, ref:illness]	
#ProfitsOverPeople	profits:[, business]	people:[, social]	
#LoneStarState	star:[, accepting]	state:[, place]	
#DontTouchMyChildren	children:[, social]	my:[, 1st, social]	dont:[, negation, rejecting]	
#ResistTheLeakyJab	leaky:[, information, rejecting]	resist:[, rejecting]	jab:[, ref:vaccine, solution]	
#CovidVAXBullies	covid:[, problem, ref:covid]	bullies:[, rejecting]	
#AdverseReactions	adverse:[, problem]	
#GlobalDictatorship	global:[, place]	dictatorship:[, distrust, political, rejecting]	
#VaccinationControlGroup	control:[, responsibilities]	group:[, social]	vaccination:[, ref:vaccine, solution]	
#SaveTheKidsFromCovidVax	covid:[, problem, ref:covid]	save:[, accepting]	vax:[, ref:vaccine, solution]	kids:[, social]	
#StopTheMandate	mandate:[, responsibilities]	stop:[, rejecting]	
#LetsGoDrakeford	go:[, accepting]	lets:[, accepting]	
#NeverForgetJanuaryth	never:[, negation, rejecting]	forget:[, rejecting]	
#HealthcareIsAHumanRight	is:[, opinionated]	right:[, accepting]	human:[, social]	healthcare:[, solution]	
#arrestGatez	arrest:[, rejecting]	gatez:[, personal]	
#NoJabsKids	no:[, negation, rejecting]	jabs:[, ref:vaccine, solution]	kids:[, social]	
#LetDownLeft	left:[, leftwing, political]	let:[, accepting]	
#NoBraDay	no:[, negation, rejecting]	day:[, time]	
#PureBlood	pure:[, accepting]	
#TrudeauCrimeFamily	trudeau:[, leftwing, personal, political, ref:trudeau, social]	crime:[, ref:crime, rejecting]	family:[, social]	
#SayNoToMandates	no:[, negation, rejecting]	mandates:[, responsibilities]	
#NoGrea	no:[, negation, rejecting]	
#IwillNotComply	not:[, negation, rejecting]	comply:[, accepting, responsibilities]	iwill:[, accepting]	
#NoGree	no:[, negation, rejecting]	
#RealNotRare	not:[, negation, rejecting]	real:[, accepting]	
#FundamentalRights	rights:[, rights]	
#ThursdayThoughts	thursday:[, time]	
#RogerStone	roger:[, personal]	stone:[, information]	
#NoVaccin	vaccin:[, ref:vaccine, solution]	no:[, negation, rejecting]	
#ControlByTheMedia	control:[, responsibilities]	media:[, information, ref:media]	
#NotGuilty	not:[, negation, rejecting]	guilty:[, distrust, rejecting]	
#PrinceAndrew	andrew:[, personal]	prince:[, accepting]	
#AfricaUnite	africa:[, place, ref:africa]	unite:[, social]	
#HoldThemAccountable	accountable:[, political]	them:[, 3rd, social]	
#YourTimeIsUp	is:[, opinionated]	time:[, time]	your:[, 2nd, social]	
#TimesSquare	times:[, time]	
#BidensIllegalVaccineMandate	mandate:[, responsibilities]	vaccine:[, ref:vaccine, solution]	bidens:[, leftwing, personal, political, ref:biden, ref:democrats, social]	illegal:[, rejecting]	
#AbolishTheCDC	abolish:[, rejecting]	
#BorisTheLiar	boris:[, personal, political, ref:boris_johnson, rightwing, social]	liar:[, distrust, rejecting]	
#VaccineSideEffect	vaccine:[, ref:vaccine, solution]	effect:[, problem]	
#WorldWarIII	world:[, place]	i:[, 1st, social]	war:[, rejecting]	
#NoMandatoryVaccine	no:[, negation, rejecting]	vaccine:[, ref:vaccine, solution]	mandatory:[, responsibilities]	
#LeaveOurKidsAlone	leave:[, rejecting]	our:[, 1st, social]	kids:[, social]	
#CampForFreedom	freedom:[, rights]	for:[, accepting]	camp:[, place]	
#NotTheFlu	not:[, negation, rejecting]	flu:[, problem, ref:illness]	
#TrumpCult	trump:[, personal, political, ref:donald_trump, ref:trump, rightwing, social]	cult:[, distrust, rejecting]	
#VelvetRevolution	revolution:[, rejecting]	
#MondayMotiv	monday:[, time]	
#ClimateChage	climate:[, problem, ref:climate, ref:nature]	
#UKParliament	parliament:[, authority, political]	
#NoNewNorm	no:[, negation, rejecting]	
#ReformUK	reform:[, rejecting]	
#boycottTesco	tesco:[, business]	boycott:[, rejecting]	
#YoungPatriots	young:[, time]	patriots:[, accepting]	
#ImWithKylieight	im:[, 1st, social]	
#BoycottBiasedMedia	biased:[, rejecting]	media:[, information, ref:media]	boycott:[, rejecting]	
#DougBrodieForPM	doug:[, personal]	for:[, accepting]	
#NoNutNovemberChallenge	november:[, time]	no:[, negation, rejecting]	challenge:[, problem]	nut:[, rejecting]	
#HandsOffOurKids	our:[, 1st, social]	kids:[, social]	
#RIPAustria	i:[, 1st, social]	austria:[, place, ref:austria]	
#CdnSci	sci:[, scientific]	cdn:[, place, political]	
#WorldWideRallyForFreedom	world:[, place]	freedom:[, rights]	for:[, accepting]	rally:[, accepting]	
#VaxFlop	flop:[, rejecting]	vax:[, ref:vaccine, solution]	
#NoBooster	no:[, negation, rejecting]	booster:[, ref:vaccine, solution]	
#WesupportNoel	wesupport:[, accepting]	
#PsakiBomb	bomb:[, rejecting]	psaki:[, leftwing, personal]	
#WeedOutBadDoctors	bad:[, rejecting]	doctors:[, authority]	
#FullyVaccinated	vaccinated:[, ref:vaccine, solution]	
#InformedCo	informed:[, information]	co:[, problem, ref:carbon, ref:nature]	
#AaronRogers	aaron:[, personal, ref:aaron_rodgers]	rogers:[, personal]	
#DoNotC	not:[, negation, rejecting]	do:[, accepting]	
#NoForcedVaccine	no:[, negation, rejecting]	vaccine:[, ref:vaccine, solution]	forced:[, rejecting]	
#BackTheBlue	blue:[, leftwing, political]	
#BigGovt	govt:[, political]	
#UsforThemUK	them:[, 3rd, social]	
#WorldWiseWalkout	wise:[, accepting]	world:[, place]	walkout:[, rejecting]	
#VaccinateYourChildren	vaccinate:[, ref:vaccine, solution]	children:[, social]	your:[, 2nd, social]	
#NoVaccinePas	no:[, negation, rejecting]	vaccine:[, ref:vaccine, solution]	
#BigPharmaScam	scam:[, distrust, rejecting]	pharma:[, business, ref:pharma]	
#GettingMyBooster	getting:[, accepting]	my:[, 1st, social]	booster:[, ref:vaccine, solution]	
#ResignJacinda	jacinda:[, personal, ref:jacinda_ardern]	resign:[, rejecting]	
#GetTheBooster	get:[, accepting]	booster:[, ref:vaccine, solution]	
#RTECovidLIARS	covid:[, problem, ref:covid]	i:[, 1st, social]	
#MelbourneCityCouncil	city:[, place]	council:[, political]	melbourne:[, place, ref:australia]	
#NoCompulsoryVaccines	no:[, negation, rejecting]	compulsory:[, responsibilities]	vaccines:[, ref:vaccine, solution]	
#IamMillion	million:[, numeric]	
#LetsGoBozo	go:[, accepting]	lets:[, accepting]	bozo:[, rejecting]	
#SoldierOfGods	gods:[, religious]	
#DPOPShot	shot:[, ref:vaccine, solution]	
#NoMedicalApar	no:[, negation, rejecting]	medical:[, authority, scientific]	
##DanGone	dan:[, personal]	
#StopVaccineCoercion	vaccine:[, ref:vaccine, solution]	stop:[, rejecting]	coercion:[, rejecting]	
#SundayMoti	sunday:[, time]	
#VaccinePas	vaccine:[, ref:vaccine, solution]	
#SkyFall	sky:[, place, ref:nature]	fall:[, rejecting]	
#CovidBullies	covid:[, problem, ref:covid]	bullies:[, rejecting]	
#NoVaccineMandates#	no:[, negation, rejecting]	vaccine:[, ref:vaccine, solution]	mandates:[, responsibilities]	
#CovidIsOver	covid:[, problem, ref:covid]	is:[, opinionated]	
#CommUNITYimmUNITY	i:[, 1st, social]	
#SouthSac	south:[, place]	
#GasPriceHike	price:[, business]	gas:[, ref:fossil_fuel, ref:gas, solution]	
#TruthBOMB	truth:[, information, rights]	
#SundayThought	sunday:[, time]	
#DallasTX	dallas:[, place, ref:america, ref:texas]	
#NameandShame	shame:[, rejecting]	
#TakeBackOurPower	take:[, accepting]	power:[, authority]	our:[, 1st, social]	
#DiabolicalPlan	diabolical:[, ref:crime, rejecting]	
#NoVaccinepassportsAnywhere	no:[, negation, rejecting]	
#AustralianRevolutioNow	now:[, time]	australian:[, place, ref:australia]	
#TelegraphScamdemic	scamdemic:[, distrust, rejecting]	
#COVIDisAirborne	airborne:[, problem]	i:[, 1st, social]	
#UnityOverDivision	unity:[, accepting]	
#COVIDnsw	i:[, 1st, social]	
#HoldTheLine#DoNotComply	not:[, negation, rejecting]	comply:[, accepting, responsibilities]	do:[, accepting]	
#InjectCriticalThinking	critical:[, rejecting]	thinking:[, accepting]	inject:[, accepting, solution]	
#VaccineEfficacy	vaccine:[, ref:vaccine, solution]	efficacy:[, solution]	
#OmicronVarientvery	omicron:[, problem, ref:illness]	
#MyTwitterAnniversary	twitter:[, information, ref:media]	my:[, 1st, social]	anniversary:[, time]	
#ScottGreen	green:[, ref:green, solution]	scott:[, personal, political, ref:scott_morrison, rightwing]	
#NoVacc	no:[, negation, rejecting]	vacc:[, ref:vaccine, solution]	
#NoVaccinePassportAnywhe	no:[, negation, rejecting]	vaccine:[, ref:vaccine, solution]	passport:[, ref:passport, responsibilities]	
#VaxHarm	harm:[, problem]	vax:[, ref:vaccine, solution]	
#CovidPaSS	covid:[, problem, ref:covid]	
#IWillNotComply	not:[, negation, rejecting]	comply:[, accepting, responsibilities]	will:[, time]	i:[, 1st, social]	
#StopVaccineMandates	vaccine:[, ref:vaccine, solution]	stop:[, rejecting]	mandates:[, responsibilities]	
#teamUnvaccinated	unvaccinated:[, ref:vaccine, rejecting]	team:[, accepting]	
#WakeUpSheeple	sheeple:[, rejecting]	
#LyndonClark	clark:[, personal]	lyndon:[, personal, political]	
#BitcoinSV	bitcoin:[, business]	
#StopGettingTeste	getting:[, accepting]	stop:[, rejecting]	
#NeverVoteConservative	never:[, negation, rejecting]	conservative:[, political, rightwing]	vote:[, accepting]	
#VaccinVirus	vaccin:[, ref:vaccine, solution]	virus:[, problem, ref:illness]	
#HoldYourLine	your:[, 2nd, social]	
#letsgoBranden	letsgo:[, accepting]	
#NoToPlanB	no:[, negation, rejecting]	
#WorldWideFreedomRally	world:[, place]	freedom:[, rights]	rally:[, accepting]	
#BorisJohnsonHates	boris:[, personal, political, ref:boris_johnson, rightwing, social]	johnson:[, personal, political, ref:boris_johnson, rightwing, social]	hates:[, rejecting]	
#FrenchResistance	resistance:[, rejecting]	french:[, place, ref:france]	
#WeAreAllInThisTogether	are:[, opinionated]	together:[, social]	we:[, 1st, social]	
#GetVacc	get:[, accepting]	vacc:[, ref:vaccine, solution]	
#UsefulIdiots	idiots:[, rejecting]	
#CCPChina	china:[, place, ref:china]	
#NotAVaccine	vaccine:[, ref:vaccine, solution]	not:[, negation, rejecting]	
#ASTROWORLDFest	fest:[, social]	
#UsForTheUK	for:[, accepting]	us:[, social]	
#NoScrubs	no:[, negation, rejecting]	
#AllStates	states:[, place]	
#DountoOthers	others:[, social]	
#DontBeATwa	be:[, accepting]	dont:[, negation, rejecting]	
#BorisOut	boris:[, personal, political, ref:boris_johnson, rightwing, social]	
#CardiffProtest	protest:[, rejecting]	cardiff:[, place, ref:uk, ref:wales]	
#DoNotForceForVaccine	vaccine:[, ref:vaccine, solution]	not:[, negation, rejecting]	for:[, accepting]	force:[, accepting]	do:[, accepting]	
#DigitalID	digital:[, solution]	i:[, 1st, social]	
#PlayStupidGames	stupid:[, rejecting]	
#BigPharmaSalesman	salesman:[, business]	pharma:[, business, ref:pharma]	
#NHSVaccinemandates	vaccinemandates:[, ref:vaccine, responsibilities, solution]	
#FcukOffMichaelMartin	michael:[, personal]	martin:[, personal]	fcuk:[, rejecting, vulgar]	
#DestroyTheTories	tories:[, political, ref:uk, rightwing]	destroy:[, rejecting]	
#StopAsianHate	stop:[, rejecting]	asian:[, place, ref:asia]	hate:[, rejecting]	
#DoNotGetV	not:[, negation, rejecting]	get:[, accepting]	do:[, accepting]	
#DontBelieveTheHype	hype:[, rejecting]	believe:[, accepting]	dont:[, negation, rejecting]	
#AreYouBrightEnough	are:[, opinionated]	you:[, 2nd, social]	
#NoGreenPassObbliga	no:[, negation, rejecting]	green:[, ref:green, solution]	pass:[, ref:passport, responsibilities]	
#KidsNeedFreshAirNotShots	not:[, negation, rejecting]	shots:[, ref:vaccine, solution]	fresh:[, accepting]	kids:[, social]	
#TheHague	hague:[, place]	
#GlennBeck	glenn:[, personal]	
#IrishMediaScum	irish:[, place, ref:ireland]	media:[, information, ref:media]	scum:[, rejecting]	
#GetVaccin	vaccin:[, ref:vaccine, solution]	get:[, accepting]	
#DisbandNPHET	disband:[, rejecting]	
#TogetherDeclaratio	together:[, social]	
#DavosAgenda	davos:[, personal, political, rightwing]	agenda:[, political]	
#EnoughIsEnou	is:[, opinionated]	
#NursinghomeGenocide	genocide:[, ref:crime, rejecting]	
#virtueSignallers	virtue:[, accepting]	
#VaccinesAreFree	are:[, opinionated]	vaccines:[, ref:vaccine, solution]	free:[, rights]	
#ThisIsOurSh	is:[, opinionated]	our:[, 1st, social]	
#StopGlobalChildAbuse	abuse:[, rejecting]	stop:[, rejecting]	global:[, place]	child:[, social]	
#SpiderManNoWayHome	no:[, negation, rejecting]	spider:[, animal]	home:[, social]	
#PersonalChoice	personal:[, personal]	choice:[, rights]	
#UKMedia	media:[, information, ref:media]	
#NHSJobs	jobs:[, business]	
#NurembergTrials	trials:[, scientific, solution]	nuremberg:[, political, ref:nuremberg, rejecting]	
#thNovember	november:[, time]	
#NoGreenPassObligato	no:[, negation, rejecting]	green:[, ref:green, solution]	pass:[, ref:passport, responsibilities]	
#PoopyPantsBiden	biden:[, leftwing, personal, political, ref:biden, ref:democrats, social]	poopy:[, rejecting]	
#NationalGuard	national:[, place]	
#StaySafeStayHealthy	healthy:[, rights]	safe:[, rights]	stay:[, accepting]	
#ErieCounty	county:[, place]	
#DefundMandates	defund:[, rejecting]	mandates:[, responsibilities]	
#BootLickers	lickers:[, rejecting]	boot:[, rejecting]	
#CatherineAustinFitts	catherine:[, personal]	
#DiabetesHeres	diabetes:[, problem, ref:illness]	
#ResistTyrannyNow	tyranny:[, distrust, rejecting]	now:[, time]	resist:[, rejecting]	
#RemoveDonnelly	donnelly:[, personal]	remove:[, rejecting]	
#TalkLiberation	liberation:[, rights]	
#JeremyVineon	jeremy:[, personal]	
#noplanB	noplan:[, negation, rejecting]	
#CovidVaccination	covid:[, problem, ref:covid]	vaccination:[, ref:vaccine, solution]	
#FootieStories	stories:[, information]	
#PplArePublicHealthRisks	risks:[, rejecting]	public:[, social]	are:[, opinionated]	health:[, rights]	
#GlobalistTyrant	globalist:[, rejecting]	tyrant:[, distrust, political, rejecting]	
#CovidVaxExposed	covid:[, problem, ref:covid]	exposed:[, rejecting]	vax:[, ref:vaccine, solution]	
#VaxPimp	pimp:[, business, ref:crime, rejecting]	vax:[, ref:vaccine, solution]	
#DoNotcomply	do:[, accepting]	
#NoVaccinesForKids	no:[, negation, rejecting]	vaccines:[, ref:vaccine, solution]	for:[, accepting]	kids:[, social]	
#SouthAfricaVariant	africa:[, place, ref:africa]	south:[, place]	variant:[, problem, ref:illness]	
#FIFAMobile	i:[, 1st, social]	
#DrDogKiller	killer:[, ref:crime, rejecting]	dog:[, animal]	dr:[, authority]	
#NoVaccineMand	no:[, negation, rejecting]	vaccine:[, ref:vaccine, solution]	
#ScrapTheAct	scrap:[, rejecting]	act:[, accepting]	
#DoNotUseTheNHS	not:[, negation, rejecting]	use:[, accepting]	do:[, accepting]	
#KyleRittenhouse	kyle:[, personal]	rittenhouse:[, personal]	
#NuVariant	variant:[, problem, ref:illness]	
#TrudeauMustGo	trudeau:[, leftwing, personal, political, ref:trudeau, social]	go:[, accepting]	must:[, responsibilities]	
#SegregationDay	segregation:[, racial]	day:[, time]	
#SesameStreet	street:[, place]	sesame:[, accepting]	
#GeenQR	q:[, political, ref:q, rightwing]	
#VaccinePassports	vaccine:[, ref:vaccine, solution]	passports:[, ref:passport, responsibilities]	
#VaccineMa	vaccine:[, ref:vaccine, solution]	ma:[, social]	
#CovidHoaxDictatorship	covid:[, problem, ref:covid]	dictatorship:[, distrust, political, rejecting]	hoax:[, distrust, rejecting]	
#EndTheLockdown	lockdown:[, responsibilities]	end:[, rejecting]	
#JairBolsonaro	bolsonaro:[, personal, political, ref:brazil, rightwing]	
#PeaceRiverNorth	north:[, place]	peace:[, solution]	river:[, place]	
#MaskItOrCasket	casket:[, problem]	mask:[, ref:mask, solution]	
#CrimesAgainstChildren	children:[, social]	against:[, rejecting]	crimes:[, problem, ref:crime, rejecting]	
#rdJab	jab:[, ref:vaccine, solution]	
#TheGreatAmericanStrike	strike:[, rejecting]	american:[, place, ref:america]	great:[, accepting]	
#SundayMotivation	sunday:[, time]	motivation:[, accepting]	
#GetVaccinate	vaccinate:[, ref:vaccine, solution]	get:[, accepting]	
#AussieNazisForceVaccinate	vaccinate:[, ref:vaccine, solution]	force:[, accepting]	aussie:[, place, ref:australia]	nazis:[, distrust, political, ref:fascism, rejecting]	
#CocainePsychosis	psychosis:[, rejecting]	
#FingerBill	bill:[, political]	
#MediaBlackout	blackout:[, information]	media:[, information, ref:media]	
#NoJab	no:[, negation, rejecting]	jab:[, ref:vaccine, solution]	
#ShareTheLove	love:[, accepting]	share:[, accepting]	
#NoMandatory	no:[, negation, rejecting]	mandatory:[, responsibilities]	
#novemberDenHaag	november:[, time]	
#SinisterAgenda	sinister:[, rejecting]	agenda:[, political]	
#CoronaInfoCH	corona:[, problem, ref:corona, ref:illness]	info:[, information]	
#LiberalSpring	spring:[, time]	liberal:[, leftwing, political]	
#VaccineDeath	vaccine:[, ref:vaccine, solution]	death:[, problem]	
#HappeningNow	now:[, time]	
#IStandWithDorisGrinspun	doris:[, personal]	i:[, 1st, social]	stand:[, accepting]	
#standTogether	stand:[, accepting]	together:[, social]	
#NoToMandatoryVaccination	no:[, negation, rejecting]	mandatory:[, responsibilities]	vaccination:[, ref:vaccine, solution]	
#BigTech	tech:[, solution]	
#VaccinationObligatoire	obligatoire:[, responsibilities]	vaccination:[, ref:vaccine, solution]	
#JailDanAndrews	dan:[, personal]	jail:[, ref:crime, rejecting]	andrews:[, personal]	
#FreeDonziger	free:[, rights]	
#ToriesUnfitToGovern	tories:[, political, ref:uk, rightwing]	govern:[, authority]	unfit:[, rejecting]	
#AntiFascist	fascist:[, distrust, political, ref:fascism, rejecting]	anti:[, rejecting]	
#standwithItaly	standwith:[, accepting]	italy:[, place, ref:italy]	
#DomsNext	next:[, time]	
#TrumpWon	trump:[, personal, political, ref:donald_trump, ref:trump, rightwing, social]	won:[, accepting]	
#CovidIreland	covid:[, problem, ref:covid]	ireland:[, place, ref:ireland]	
#NewNazis	nazis:[, distrust, political, ref:fascism, rejecting]	
#VaccineBuddy	vaccine:[, ref:vaccine, solution]	buddy:[, accepting]	
#PutSouthAfricaFirst	africa:[, place, ref:africa]	south:[, place]	
#SouthAustralia	south:[, place]	australia:[, place, ref:australia]	
#ClimateEmergenc	climate:[, problem, ref:climate, ref:nature]	
#GodHelpUs	help:[, accepting]	god:[, religious]	us:[, social]	
#PurebloodsUnited	united:[, accepting]	
#TogetherDeclarati	together:[, social]	
#CoercionIsNotConsent	not:[, negation, rejecting]	coercion:[, rejecting]	is:[, opinionated]	consent:[, rights]	
#BritishColumbia	columbia:[, place, ref:university]	british:[, place, ref:uk]	
#MedicalAparthei	medical:[, authority, scientific]	
#FolloMe	me:[, social]	
#VaccineAgenda	vaccine:[, ref:vaccine, solution]	agenda:[, political]	
#PayCash	pay:[, business]	cash:[, business]	
#CelineDion	celine:[, personal]	
#WorldWideWalkout	world:[, place]	walkout:[, rejecting]	
#AuspolSoCorrupt	auspol:[, place, political, ref:australia]	corrupt:[, distrust, rejecting]	
#FutureFacts	future:[, time]	facts:[, information]	
#TruthSocial	truth:[, information, rights]	social:[, social]	
#portualidiTrieste	trieste:[, place, ref:austria]	
#EndGunViolence	end:[, rejecting]	violence:[, problem, ref:crime]	
#SaturdayMotivation	saturday:[, time]	motivation:[, accepting]	
#NationwideWalkout	nationwide:[, place]	walkout:[, rejecting]	
#FlawedData	data:[, information, scientific]	flawed:[, rejecting]	
#PuertoRico	puerto:[, place]	
#DrJohnCampbell	john:[, personal]	dr:[, authority]	
#NoMAGA	no:[, negation, rejecting]	
#CoronaVirus	virus:[, problem, ref:illness]	corona:[, problem, ref:corona, ref:illness]	
#IconoclastRoundtable	iconoclast:[, accepting]	roundtable:[, social]	
#FluVaccine	vaccine:[, ref:vaccine, solution]	flu:[, problem, ref:illness]	
#EndTheTyranny	tyranny:[, distrust, rejecting]	end:[, rejecting]	
#NowListening	listening:[, accepting]	now:[, time]	
#VaccinesSavesLives	lives:[, social]	vaccines:[, ref:vaccine, solution]	
#RPSMTrust	trust:[, accepting]	
#MichaelGunner	michael:[, personal]	
#TestTheVaccinated	test:[, solution]	vaccinated:[, ref:vaccine, solution]	
#NappyHappy	happy:[, accepting]	
#SouthwestAirlines	airlines:[, business]	
#COVIDIsAirborne	airborne:[, problem]	i:[, 1st, social]	is:[, opinionated]	
#NoMasksInSchool	no:[, negation, rejecting]	school:[, place]	masks:[, ref:mask, solution]	
#ChicagoIL	i:[, 1st, social]	chicago:[, place, ref:america]	
#BillGatesOfHell	gates:[, personal, ref:bill_gates]	bill:[, political]	hell:[, rejecting]	
#RevolutionWillNotBeTelevised	not:[, negation, rejecting]	be:[, accepting]	will:[, time]	revolution:[, rejecting]	
#ThisIsAWa	wa:[, place]	is:[, opinionated]	
#CovidCanada	covid:[, problem, ref:covid]	canada:[, place, ref:canada]	
#GreenNewDeal	deal:[, business]	green:[, ref:green, solution]	
#LetsGoNicola	nicola:[, personal]	go:[, accepting]	lets:[, accepting]	
#LondonOntario	london:[, place, ref:uk]	ontario:[, place, ref:canada]	
#AnswerTheQuestion	question:[, rejecting]	answer:[, information]	
#LoyalLimbrick	loyal:[, accepting]	
#ChrisWallace	chris:[, personal]	
#QandA	qand:[, political, ref:q, rightwing]	
#StandUp	stand:[, accepting]	
#MonicaSmit	monica:[, personal]	
#StandUn	un:[, authority, political]	stand:[, accepting]	
#DanGone	dan:[, personal]	
#QuestionEver	question:[, rejecting]	
#FinancialCrash	financial:[, business]	crash:[, rejecting]	
#NoToDiscrimination	no:[, negation, rejecting]	discrimination:[, racial]	
#HumanRightsDay	rights:[, rights]	day:[, time]	human:[, social]	
#ArrestDanAndrews	dan:[, personal]	arrest:[, rejecting]	andrews:[, personal]	
#MedicalTyranny	medical:[, authority, scientific]	tyranny:[, distrust, rejecting]	
#GlobalistTraitors	traitors:[, distrust, rejecting]	globalist:[, rejecting]	
#NoVaccineShots	no:[, negation, rejecting]	vaccine:[, ref:vaccine, solution]	shots:[, ref:vaccine, solution]	
#UniteForfreedom	unite:[, social]	
#wewillALLbethere	wewill:[, social]	
#VaccineHesitancy	vaccine:[, ref:vaccine, solution]	hesitancy:[, rejecting]	
#BlindJoe	joe:[, leftwing, personal, political, ref:biden, ref:democrats]	blind:[, rejecting]	
#NebraskaZoo	nebraska:[, place, ref:america]	
#NonAuPasseportSanitaire	au:[, place, ref:australia]	passeport:[, ref:passport, responsibilities]	sanitaire:[, solution]	
#BlackMirror	black:[, racial]	
#Tyranny#NewZealand	tyranny:[, distrust, rejecting]	
#BadPharma	bad:[, rejecting]	pharma:[, business, ref:pharma]	
#ONPoli	poli:[, political]	
#VaxBloodMoney	money:[, business]	vax:[, ref:vaccine, solution]	
#ChrisDirtroad	chris:[, personal]	
#ChicagoPD	chicago:[, place, ref:america]	
#FJBiden	biden:[, leftwing, personal, political, ref:biden, ref:democrats, social]	
#AbsoluteRiskReduction	risk:[, problem]	reduction:[, rejecting]	
#stephenDonnelly	donnelly:[, personal]	stephen:[, personal]	
#RepealTheBill	bill:[, political]	repeal:[, rejecting]	
#HeartAttack	attack:[, rejecting]	
#FauciIsEvil	is:[, opinionated]	evil:[, ref:crime, rejecting]	fauci:[, authority, personal, ref:fauci]	
#ReinstateDarren	reinstate:[, accepting]	
#DictatorTrudeau	trudeau:[, leftwing, personal, political, ref:trudeau, social]	dictator:[, distrust, political, rejecting]	
#StandTogether	stand:[, accepting]	together:[, social]	
#TaxExtortion	tax:[, authority]	extortion:[, business, rejecting]	
#NoMandatoryVac	no:[, negation, rejecting]	mandatory:[, responsibilities]	
#GreatBritain	britain:[, place, ref:uk]	great:[, accepting]	
#GermTheoryDeception	deception:[, distrust, rejecting]	germ:[, problem, ref:illness]	theory:[, information, scientific]	
#ThisIsTheir	their:[, 3rd]	is:[, opinionated]	
#DayHorrorChallenge	horror:[, rejecting]	challenge:[, problem]	day:[, time]	
#DontWaitVaccinate	vaccinate:[, ref:vaccine, solution]	dont:[, negation, rejecting]	
#DivideAndRule	rule:[, responsibilities]	divide:[, rejecting]	
#FreedomRally	freedom:[, rights]	rally:[, accepting]	
#NoMedicalAparthe	no:[, negation, rejecting]	medical:[, authority, scientific]	
#FreeItaly	free:[, rights]	italy:[, place, ref:italy]	
#MedicalMafia	medical:[, authority, scientific]	mafia:[, problem, ref:crime]	
#NoMedic	no:[, negation, rejecting]	
#TonightVMTV	tonight:[, time]	
#exemptFromBS	exempt:[, rights]	
#BetaMale	male:[, social]	
#StaySafe	safe:[, rights]	stay:[, accepting]	
#AdverseEvent	adverse:[, problem]	
#ItsJustafewWeeks	weeks:[, time]	
#GlobalWarrning	global:[, place]	
#ScrapTheA	scrap:[, rejecting]	
#VaccineEconimics	vaccine:[, ref:vaccine, solution]	econimics:[, scientific]	
#TogetherD	together:[, social]	
#NoVacci	no:[, negation, rejecting]	vacci:[, ref:vaccine, solution]	
#MyBody	body:[, social]	my:[, 1st, social]	
#CovidCuckoo	covid:[, problem, ref:covid]	cuckoo:[, animal, rejecting]	
#WrongAgainPANDA	wrong:[, rejecting]	
#DoNotCompy	not:[, negation, rejecting]	do:[, accepting]	
#BizHour	biz:[, business]	hour:[, time]	
#WeNeedTruth	truth:[, information, rights]	we:[, 1st, social]	
#DoNotCompl	not:[, negation, rejecting]	do:[, accepting]	
#COVIDvaccination	i:[, 1st, social]	
#NazismIsBack	nazism:[, political, ref:fascism, rejecting]	is:[, opinionated]	
#HelpOthersGetVaccinatedGetYourChildrenVaccinated	help:[, accepting]	children:[, social]	get:[, accepting]	your:[, 2nd, social]	vaccinated:[, ref:vaccine, solution]	others:[, social]	
#CovidNaziPass	nazi:[, distrust, ref:fascism, rejecting]	covid:[, problem, ref:covid]	pass:[, ref:passport, responsibilities]	
#SparsPandemic	pandemic:[, problem, ref:illness]	
#NoPassSanitaire	no:[, negation, rejecting]	pass:[, ref:passport, responsibilities]	sanitaire:[, solution]	
#YourCall	your:[, 2nd, social]	
#openForAll	for:[, accepting]	open:[, accepting]	
#NoFascism	no:[, negation, rejecting]	fascism:[, distrust, ref:fascism, rejecting]	
#MasksAreMoronic	moronic:[, rejecting]	are:[, opinionated]	masks:[, ref:mask, solution]	
#WuFlu	flu:[, problem, ref:illness]	
#GutsToStandUp	stand:[, accepting]	
#JustSayYes	yes:[, accepting]	
#SadLittleMan	sad:[, rejecting]	
#FakeV	fake:[, distrust, rejecting]	
#WinterfellWillNotComply	not:[, negation, rejecting]	comply:[, accepting, responsibilities]	will:[, time]	
#DrPeterRidd	peter:[, personal]	dr:[, authority]	
#chooseFreedom	freedom:[, rights]	choose:[, accepting]	
#FordFailedKids	failed:[, rejecting]	ford:[, business, personal]	kids:[, social]	
#NoMorelies	no:[, negation, rejecting]	
#SayNoToVaccineMandates	no:[, negation, rejecting]	vaccine:[, ref:vaccine, solution]	mandates:[, responsibilities]	
#TogetherStronger	stronger:[, accepting]	together:[, social]	
#HIStory	i:[, 1st, social]	story:[, information]	
#AlexJonesWasRight	alex:[, personal]	right:[, accepting]	
#NoTests	no:[, negation, rejecting]	tests:[, information]	
#FluSeason	season:[, time]	flu:[, problem, ref:illness]	
#ChrisSky	sky:[, place, ref:nature]	chris:[, personal]	
#NaturalImmunityWorks	immunity:[, solution]	
#VaccineForAll	vaccine:[, ref:vaccine, solution]	for:[, accepting]	
#DictaduraSanitaria	dictadura:[, distrust, political, rejecting]	
#NoMedicalSegregation	no:[, negation, rejecting]	medical:[, authority, scientific]	segregation:[, racial]	
#FreeAustria	austria:[, place, ref:austria]	free:[, rights]	
#GoAway	away:[, rejecting]	go:[, accepting]	
#StopTheShot	stop:[, rejecting]	shot:[, ref:vaccine, solution]	
#HandsOffOurKikds	our:[, 1st, social]	
#HateCrime	crime:[, ref:crime, rejecting]	hate:[, rejecting]	
#WalesOneVoice	voice:[, information]	wales:[, place, ref:uk, ref:wales]	
#IfYouKnowYouKnow	you:[, 2nd, social]	
#KlausSchwab	klaus:[, personal]	
#TrustFauci	trust:[, accepting]	fauci:[, authority, personal, ref:fauci]	
#TheBrandonAdministration	brandon:[, personal, political, rightwing]	administration:[, authority]	
#AmericanJournal	journal:[, scientific]	american:[, place, ref:america]	
#VaccineSideEffects	effects:[, problem]	vaccine:[, ref:vaccine, solution]	
#ResistTheMandate	mandate:[, responsibilities]	resist:[, rejecting]	
#BodilyAutonomy	autonomy:[, rights]	
#BeFearless	be:[, accepting]	fearless:[, accepting]	
#RealNews	news:[, information, ref:media]	real:[, accepting]	
#NioForcedVaccination	forced:[, rejecting]	vaccination:[, ref:vaccine, solution]	
#DemVoice	voice:[, information]	dem:[, leftwing, political, ref:democrats]	
#WeAreManyTheyAreFew	are:[, opinionated]	they:[, 3rd, social]	we:[, 1st, social]	
#MarioDraghi	mario:[, personal]	draghi:[, personal]	
#BoycottTesco	tesco:[, business]	boycott:[, rejecting]	
#NaziLand	nazi:[, distrust, ref:fascism, rejecting]	land:[, place]	
#VaccinesWo	vaccines:[, ref:vaccine, solution]	
#MainstreamMedia	media:[, information, ref:media]	
#LetsGoBrandonDay	brandon:[, personal, political, rightwing]	go:[, accepting]	lets:[, accepting]	day:[, time]	
#BuildBackBetter#Fraudci	better:[, accepting]	fraudci:[, authority, distrust, personal, ref:crime, ref:fauci, rejecting]	
#IvermectinSavesLives	lives:[, social]	ivermectin:[, ref:ivermectin, solution]	
#ChooseFreedom	freedom:[, rights]	choose:[, accepting]	
#AleksandrLoekasjenko	aleksandr:[, personal]	
#QuercetinZinc	quercetin:[, ref:drugs, solution]	
#COVIDdeaths	i:[, 1st, social]	
#MandatoryVaccinations	vaccinations:[, ref:vaccine, solution]	mandatory:[, responsibilities]	
#CovidCompassionNOW	covid:[, problem, ref:covid]	compassion:[, accepting]	
#ApartheidDay	apartheid:[, political, racial, rejecting]	day:[, time]	
#StandUpForFreedom	freedom:[, rights]	for:[, accepting]	stand:[, accepting]	
#HartGroup	hart:[, personal]	group:[, social]	
#VoteSliwa	vote:[, accepting]	
#itIsOver	is:[, opinionated]	
#TakeYourFkinMaskOff	take:[, accepting]	your:[, 2nd, social]	mask:[, ref:mask, solution]	
#ArrestFaucci	faucci:[, authority, ref:fauci]	arrest:[, rejecting]	
#MedTwitter	twitter:[, information, ref:media]	
#VaccineAdverseEffects	effects:[, problem]	vaccine:[, ref:vaccine, solution]	adverse:[, problem]	
#FreedomFest	freedom:[, rights]	fest:[, social]	
#NonAuPassDeLaH	de:[, personal]	au:[, place, ref:australia]	la:[, place]	pass:[, ref:passport, responsibilities]	
#LetsGoBranDan	dan:[, personal]	go:[, accepting]	lets:[, accepting]	
#NoGreen	no:[, negation, rejecting]	green:[, ref:green, solution]	
#humanRights	rights:[, rights]	human:[, social]	
#PushBack	push:[, accepting]	
#COVIDnearly	i:[, 1st, social]	
#IwillNOTcomply	iwill:[, accepting]	
#NoMedicalTyranny	no:[, negation, rejecting]	medical:[, authority, scientific]	tyranny:[, distrust, rejecting]	
#BornFree	free:[, rights]	
#CanYouSeeItYet	you:[, 2nd, social]	
#LetsGoBrian	go:[, accepting]	lets:[, accepting]	brian:[, personal]	
#ProtectWomenAndGi	protect:[, accepting]	women:[, social]	
#HerdImmunity	immunity:[, solution]	herd:[, rejecting]	
#BeagleGate	beagle:[, animal]	gate:[, distrust, political, rejecting]	
#ClimateCON	climate:[, problem, ref:climate, ref:nature]	
#FascistVaccinePassport	vaccine:[, ref:vaccine, solution]	passport:[, ref:passport, responsibilities]	fascist:[, distrust, political, ref:fascism, rejecting]	
#NoMoreL	no:[, negation, rejecting]	more:[, accepting]	
#ArrestHolohan	arrest:[, rejecting]	holohan:[, authority, personal, ref:tony_holohan]	
#PapersPlease	please:[, accepting]	papers:[, information, ref:media]	
#IVaxProtect	i:[, 1st, social]	protect:[, accepting]	vax:[, ref:vaccine, solution]	
#FightOSHAMandate	mandate:[, responsibilities]	fight:[, rejecting]	
#DeathSantis	death:[, problem]	santis:[, personal, ref:ron_desantis]	
#EpicFail	fail:[, rejecting]	epic:[, accepting]	
#YouNetflix	netflix:[, business]	you:[, 2nd, social]	
#SchoolChoice	school:[, place]	choice:[, rights]	
#TheAnswerIsNO	answer:[, information]	is:[, opinionated]	
#AirForce	force:[, accepting]	
#AntiHinduUnacademy	anti:[, rejecting]	
#UnitedStates	united:[, accepting]	states:[, place]	
#UtGov	gov:[, authority, political]	
#PeoplePower	power:[, authority]	people:[, social]	
#GovernmentCorruption	government:[, authority]	corruption:[, distrust, rejecting]	
#SolutionsWatch	solutions:[, solution]	
#WeWillNeverForget	never:[, negation, rejecting]	forget:[, rejecting]	will:[, time]	we:[, 1st, social]	
#FormerGuy	former:[, time]	
#UnitedWeS	united:[, accepting]	we:[, 1st, social]	
#NoMoreLo	no:[, negation, rejecting]	more:[, accepting]	
#GetABoostedBaby	get:[, accepting]	baby:[, social]	boosted:[, solution]	
#MyBodyMyChoi	body:[, social]	my:[, 1st, social]	
#FreedomsNZ	freedoms:[, rights]	
#SackChrisWhitty	chris:[, personal]	sack:[, rejecting]	whitty:[, authority, personal]	
#NoVaccineManda	no:[, negation, rejecting]	vaccine:[, ref:vaccine, solution]	
#OntarioFirst	ontario:[, place, ref:canada]	
#VaccinesKill	vaccines:[, ref:vaccine, solution]	kill:[, problem, ref:crime, rejecting]	
#notoVaccinePassports	vaccine:[, ref:vaccine, solution]	passports:[, ref:passport, responsibilities]	
#StopTh	stop:[, rejecting]	
#DdimerTest	test:[, solution]	
#WeWillWin	will:[, time]	win:[, accepting]	we:[, 1st, social]	
#RiseUpAdelaide	adelaide:[, place, ref:australia]	rise:[, rejecting]	
#CovidPSYCHOS	covid:[, problem, ref:covid]	
#NicolaSturgeon	nicola:[, personal]	sturgeon:[, personal, political, ref:nicola_sturgeon, ref:scotland]	
#ExpandtheSupremeCourt	supreme:[, authority]	court:[, authority]	expandthe:[, accepting]	
#MattGaetz	matt:[, personal]	gaetz:[, personal]	
#covidFlu	covid:[, problem, ref:covid]	flu:[, problem, ref:illness]	
#AnthonyFauci	fauci:[, authority, personal, ref:fauci]	
#WarRoom	war:[, rejecting]	
#InformedConse	informed:[, information]	
#NationalUprising	uprising:[, accepting, political]	national:[, place]	
#TogetherWeAreUnstopp	are:[, opinionated]	we:[, 1st, social]	together:[, social]	
#AustriaFascistState	state:[, place]	fascist:[, distrust, political, ref:fascism, rejecting]	austria:[, place, ref:austria]	
#AmericanCrimeStory	crime:[, ref:crime, rejecting]	american:[, place, ref:america]	story:[, information]	
#VaxxEmancipationProclimation	emancipation:[, racial, rights]	vaxx:[, solution]	
#ThisEndsNow	now:[, time]	
#SaveLives	lives:[, social]	save:[, accepting]	
#BlackRock	black:[, racial]	
#ReasonableForce	force:[, accepting]	
#SayNoTo	no:[, negation, rejecting]	
#FluShot	flu:[, problem, ref:illness]	shot:[, ref:vaccine, solution]	
#CovidBeGone	covid:[, problem, ref:covid]	be:[, accepting]	
#TwitterSpace	twitter:[, information, ref:media]	space:[, place]	
#ToKeepYouSafe	keep:[, accepting]	safe:[, rights]	you:[, 2nd, social]	
#BurnTheMask	burn:[, rejecting]	mask:[, ref:mask, solution]	
#GroupThink	group:[, social]	
#NWOMaskSlaves	slaves:[, rejecting]	mask:[, ref:mask, solution]	
#NoVaccinePass	no:[, negation, rejecting]	vaccine:[, ref:vaccine, solution]	pass:[, ref:passport, responsibilities]	
#NonAuPasseDeLaHonte	de:[, personal]	au:[, place, ref:australia]	la:[, place]	passe:[, ref:passport, responsibilities]	
#NoHealt	no:[, negation, rejecting]	
#DearEarth	earth:[, place]	dear:[, accepting]	
#VaccineMandatesWork	vaccine:[, ref:vaccine, solution]	work:[, responsibilities]	mandates:[, responsibilities]	
#UselessEaters	useless:[, rejecting]	
#YouareNotAlone	not:[, negation, rejecting]	
#GenocideByVaccin	vaccin:[, ref:vaccine, solution]	genocide:[, ref:crime, rejecting]	
#RememberReme	remember:[, accepting]	
#TogetherDeclaration#novaccinepasspo	together:[, social]	
#IfNotMeThenWho	not:[, negation, rejecting]	me:[, social]	then:[, time]	
#ChildTorture	torture:[, ref:crime, rejecting]	child:[, social]	
#JailDrRuben	jail:[, ref:crime, rejecting]	dr:[, authority]	
#MenInBlack	black:[, racial]	
#NoDiscriminationOnMyFlight	no:[, negation, rejecting]	discrimination:[, racial]	my:[, 1st, social]	
#EndAllRestrictions	restrictions:[, responsibilities]	end:[, rejecting]	
#XiVirus	xi:[, leftwing, personal, political, ref:china, ref:xi]	virus:[, problem, ref:illness]	
#DemocratsAreADisaster	are:[, opinionated]	democrats:[, leftwing, political, ref:democrats]	disaster:[, problem, ref:nature]	
#NoPlanBNeeded	no:[, negation, rejecting]	
#VaccinateAllTheDolls	vaccinate:[, ref:vaccine, solution]	
#CovidJabsArePoison	covid:[, problem, ref:covid]	poison:[, problem, ref:crime, ref:nature]	are:[, opinionated]	jabs:[, ref:vaccine, solution]	
#HellNo	no:[, negation, rejecting]	hell:[, rejecting]	
#GiletsJaunes	gilets:[, political]	
#PeoplePowerJustSayNo	no:[, negation, rejecting]	power:[, authority]	people:[, social]	
#weARRRpirate	we:[, 1st, social]	
#MurdochGutterMedia	gutter:[, rejecting]	murdoch:[, personal]	media:[, information, ref:media]